Team,FG,FGA,FG%,2P,2PA,2P%,3P,3PA,3P%,FT,FTA,ORB,TRB,AST,TOV,PTS,Year,Playoff,Finals_Rk
San Antonio Spurs,3856,7738,49.8,3804,7532,50.5,52,206,25.2,2024,2528,1153,3668,2326,1589,9788,1980,True,Knocked Out
Los Angeles Lakers,3898,7368,52.900000000000006,3878,7268,53.400000000000006,20,100,20.0,1622,2092,1085,3738,2413,1639,9438,1980,True,Champion
Cleveland Cavaliers,3811,8041,47.4,3775,7854,48.1,36,187,19.3,1702,2205,1307,3688,2108,1370,9360,1980,False,Never Qualified
New York Knicks,3802,7672,49.6,3760,7481,50.3,42,191,22.0,1698,2274,1236,3539,2265,1613,9344,1980,False,Never Qualified
Boston Celtics,3617,7387,49.0,3455,6965,49.6,162,422,38.4,1907,2449,1227,3684,2198,1539,9303,1980,True,Knocked Out
Indiana Pacers,3639,7689,47.3,3551,7375,48.1,88,314,28.000000000000004,1753,2333,1398,3724,2148,1517,9119,1980,False,Never Qualified
Phoenix Suns,3570,7235,49.3,3502,6955,50.4,68,280,24.3,1906,2466,1071,3529,2283,1629,9114,1980,True,Knocked Out
Houston Rockets,3599,7496,48.0,3495,7117,49.1,104,379,27.400000000000002,1782,2326,1394,3611,2149,1565,9084,1980,True,Knocked Out
Milwaukee Bucks,3685,7553,48.8,3635,7398,49.1,50,155,32.300000000000004,1605,2102,1245,3641,2277,1496,9025,1980,True,Knocked Out
Philadelphia 76ers,3523,7156,49.2,3496,7031,49.7,27,125,21.6,1876,2431,1187,3822,2226,1708,8949,1980,True,Runner-Up
Detroit Pistons,3643,7596,48.0,3586,7377,48.6,57,219,26.0,1590,2149,1226,3641,1950,1742,8933,1980,False,Never Qualified
Oklahoma City Thunder,3554,7565,47.0,3495,7376,47.4,59,189,31.2,1730,2253,1380,3930,2043,1496,8897,1980,True,Knocked Out
Brooklyn Nets,3456,7504,46.1,3371,7206,46.800000000000004,85,298,28.499999999999996,1882,2406,1229,3764,2094,1702,8879,1980,False,Never Qualified
Denver Nuggets,3462,7470,46.300000000000004,3379,7215,46.800000000000004,83,255,32.5,1871,2539,1311,3835,2079,1533,8878,1980,False,Never Qualified
Sacramento Kings,3582,7489,47.8,3557,7375,48.199999999999996,25,114,21.9,1671,2250,1187,3616,2123,1439,8860,1980,True,Knocked Out
Los Angeles Clippers,3524,7494,47.0,3347,6951,48.199999999999996,177,543,32.6,1595,2167,1294,3602,1688,1443,8820,1980,False,Never Qualified
Chicago Bulls,3362,6943,48.4,3292,6668,49.4,70,275,25.5,2019,2592,1115,3580,2152,1684,8813,1980,False,Never Qualified
Washington Wizards,3574,7796,45.800000000000004,3501,7558,46.300000000000004,73,238,30.7,1552,2048,1334,4057,2201,1380,8773,1980,True,Knocked Out
Atlanta Hawks,3261,7027,46.400000000000006,3248,6952,46.7,13,75,17.299999999999997,2038,2645,1369,3775,1913,1495,8573,1980,True,Knocked Out
Golden State Warriors,3527,7318,48.199999999999996,3500,7197,48.6,27,121,22.3,1412,1914,1155,3592,2028,1492,8493,1980,False,Never Qualified
Portland Trail Blazers,3408,7167,47.599999999999994,3382,7035,48.1,26,132,19.7,1560,2100,1295,3703,1898,1552,8402,1980,True,Knocked Out
Utah Jazz,3382,6817,49.6,3323,6632,50.1,59,185,31.900000000000002,1571,1943,967,3326,2005,1543,8394,1980,False,Never Qualified
Denver Nuggets,3784,7960,47.5,3754,7815,48.0,30,145,20.7,2388,3051,1325,3822,2030,1444,9986,1981,False,Never Qualified
Milwaukee Bucks,3722,7472,49.8,3692,7341,50.3,30,131,22.900000000000002,1802,2340,1261,3669,2319,1581,9276,1981,True,Knocked Out
San Antonio Spurs,3571,7276,49.1,3556,7191,49.5,15,85,17.599999999999998,2052,2668,1304,3886,2048,1533,9209,1981,True,Knocked Out
Philadelphia 76ers,3636,7073,51.4,3617,6989,51.800000000000004,19,84,22.6,1865,2427,1091,3709,2369,1702,9156,1981,True,Knocked Out
Los Angeles Lakers,3780,7382,51.2,3763,7288,51.6,17,94,18.099999999999998,1540,2113,1165,3656,2363,1557,9117,1981,True,Knocked Out
Portland Trail Blazers,3741,7535,49.6,3716,7387,50.3,25,148,16.900000000000002,1573,2191,1243,3631,2244,1518,9080,1981,True,Knocked Out
Phoenix Suns,3587,7326,49.0,3552,7165,49.6,35,161,21.7,1810,2430,1234,3724,2205,1733,9019,1981,True,Knocked Out
Boston Celtics,3581,7099,50.4,3516,6858,51.300000000000004,65,241,27.0,1781,2369,1155,3579,2202,1577,9008,1981,True,Champion
Golden State Warriors,3560,7284,48.9,3500,7074,49.5,60,210,28.599999999999998,1826,2513,1403,3769,2026,1547,9006,1981,False,Never Qualified
Chicago Bulls,3457,6903,50.1,3419,6724,50.8,38,179,21.2,1985,2563,1227,3702,1925,1672,8937,1981,True,Knocked Out
Houston Rockets,3573,7335,48.699999999999996,3552,7217,49.2,21,118,17.8,1711,2223,1216,3563,2099,1451,8878,1981,True,Runner-Up
New York Knicks,3505,7255,48.3,3449,7019,49.1,56,236,23.7,1783,2386,1137,3342,1976,1461,8849,1981,True,Knocked Out
Indiana Pacers,3491,7245,48.199999999999996,3461,7076,48.9,30,169,17.8,1815,2540,1325,3592,2091,1491,8827,1981,True,Knocked Out
Sacramento Kings,3572,7151,50.0,3523,6983,50.5,49,168,29.2,1576,2206,1037,3487,2271,1448,8769,1981,True,Knocked Out
Brooklyn Nets,3477,7314,47.5,3443,7176,48.0,34,138,24.6,1780,2371,1092,3466,2068,1664,8768,1981,False,Never Qualified
Los Angeles Clippers,3477,7283,47.699999999999996,3345,6876,48.6,132,407,32.4,1651,2246,1169,3313,2098,1407,8737,1981,False,Never Qualified
Cleveland Cavaliers,3556,7609,46.7,3484,7360,47.3,72,249,28.9,1486,1909,1258,3501,2007,1396,8670,1981,False,Never Qualified
Washington Wizards,3549,7517,47.199999999999996,3484,7276,47.9,65,241,27.0,1499,2072,1155,3688,2151,1422,8662,1981,False,Never Qualified
Atlanta Hawks,3291,6866,47.9,3281,6784,48.4,10,82,12.2,2012,2590,1201,3425,1846,1605,8604,1981,False,Never Qualified
Oklahoma City Thunder,3343,7145,46.800000000000004,3311,7028,47.099999999999994,32,117,27.400000000000002,1813,2376,1167,3601,1945,1524,8531,1981,False,Never Qualified
Dallas Mavericks,3204,6928,46.2,3158,6763,46.7,46,165,27.900000000000002,1868,2487,1109,3286,1984,1439,8322,1981,False,Never Qualified
Utah Jazz,3332,6825,48.8,3290,6662,49.4,42,163,25.8,1595,2080,962,3287,1948,1423,8301,1981,False,Never Qualified
Detroit Pistons,3236,6986,46.300000000000004,3223,6902,46.7,13,84,15.5,1689,2330,1201,3312,1819,1759,8174,1981,False,Never Qualified
Denver Nuggets,3980,7656,52.0,3940,7507,52.5,40,149,26.8,2371,2978,1149,3592,2272,1470,10371,1982,True,Knocked Out
Los Angeles Lakers,3919,7585,51.7,3906,7491,52.1,13,94,13.8,1549,2161,1258,3763,2356,1468,9400,1982,True,Champion
San Antonio Spurs,3698,7613,48.6,3634,7361,49.4,64,252,25.4,1812,2335,1253,3790,2257,1293,9272,1982,True,Knocked Out
Boston Celtics,3657,7334,49.9,3608,7150,50.5,49,184,26.6,1817,2457,1253,3742,2126,1452,9180,1982,True,Knocked Out
Philadelphia 76ers,3616,6974,51.800000000000004,3575,6835,52.300000000000004,41,139,29.5,1846,2471,1031,3420,2264,1474,9119,1982,True,Runner-Up
Detroit Pistons,3561,7391,48.199999999999996,3509,7178,48.9,52,213,24.4,1938,2581,1298,3643,2027,1629,9112,1982,False,Never Qualified
Utah Jazz,3679,7446,49.4,3657,7349,49.8,22,97,22.7,1714,2282,1147,3509,1895,1435,9094,1982,False,Never Qualified
Golden State Warriors,3646,7349,49.6,3555,7024,50.6,91,325,28.000000000000004,1709,2382,1282,3734,1820,1424,9092,1982,False,Never Qualified
Portland Trail Blazers,3629,7187,50.5,3600,7047,51.1,29,140,20.7,1719,2387,1142,3497,2054,1390,9006,1982,False,Never Qualified
Los Angeles Clippers,3552,7101,50.0,3453,6763,51.1,99,338,29.299999999999997,1693,2341,1131,3327,1878,1570,8896,1982,False,Never Qualified
Milwaukee Bucks,3544,7015,50.5,3495,6851,51.0,49,164,29.9,1753,2329,1167,3582,2233,1589,8890,1982,True,Knocked Out
Oklahoma City Thunder,3505,7178,48.8,3467,7025,49.4,38,153,24.8,1747,2362,1103,3647,2103,1351,8795,1982,True,Knocked Out
Sacramento Kings,3604,7284,49.5,3578,7154,50.0,26,130,20.0,1551,2158,1086,3362,2056,1507,8785,1982,False,Never Qualified
Brooklyn Nets,3501,7227,48.4,3471,7081,49.0,30,146,20.5,1714,2354,1194,3514,2096,1650,8746,1982,True,Knocked Out
Chicago Bulls,3369,6728,50.1,3315,6515,50.9,54,213,25.4,1951,2545,1125,3650,2043,1636,8743,1982,False,Never Qualified
New York Knicks,3523,7178,49.1,3465,6964,49.8,58,214,27.1,1603,2171,1168,3441,2075,1486,8707,1982,False,Never Qualified
Phoenix Suns,3508,7140,49.1,3454,6966,49.6,54,174,31.0,1635,2157,1123,3640,2223,1528,8705,1982,True,Knocked Out
Houston Rockets,3504,7366,47.599999999999994,3454,7190,48.0,50,176,28.4,1622,2225,1403,3687,1977,1321,8680,1982,True,Knocked Out
Dallas Mavericks,3390,7224,46.9,3335,7034,47.4,55,190,28.9,1740,2366,1213,3441,2117,1317,8575,1982,False,Never Qualified
Washington Wizards,3400,7168,47.4,3341,6932,48.199999999999996,59,236,25.0,1626,2105,1047,3630,1983,1390,8485,1982,True,Knocked Out
Cleveland Cavaliers,3405,7334,46.400000000000006,3380,7197,47.0,25,137,18.2,1628,2179,1190,3360,1871,1319,8463,1982,False,Never Qualified
Indiana Pacers,3332,7164,46.5,3229,6848,47.199999999999996,103,316,32.6,1612,2176,1141,3513,1897,1393,8379,1982,False,Never Qualified
Atlanta Hawks,3210,6776,47.4,3182,6648,47.9,28,128,21.9,1833,2387,1135,3503,1815,1343,8281,1982,True,Knocked Out
Denver Nuggets,3951,7999,49.4,3927,7873,49.9,24,126,19.0,2179,2696,1214,3738,2336,1496,10105,1983,True,Knocked Out
Los Angeles Lakers,3964,7512,52.800000000000004,3954,7416,53.300000000000004,10,96,10.4,1495,2031,1235,3668,2519,1584,9433,1983,True,Runner-Up
San Antonio Spurs,3697,7340,50.4,3603,7032,51.2,94,308,30.5,1887,2468,1232,3831,2261,1504,9375,1983,True,Knocked Out
Sacramento Kings,3719,7485,49.7,3668,7270,50.5,51,215,23.7,1839,2530,1256,3663,2155,1691,9328,1983,False,Never Qualified
Dallas Mavericks,3674,7550,48.699999999999996,3631,7365,49.3,43,185,23.200000000000003,1852,2462,1296,3677,2227,1348,9243,1983,False,Never Qualified
Detroit Pistons,3623,7602,47.699999999999996,3551,7330,48.4,72,272,26.5,1921,2588,1312,3789,2108,1557,9239,1983,False,Never Qualified
Boston Celtics,3711,7547,49.2,3672,7361,49.9,39,186,21.0,1730,2348,1273,3805,2216,1541,9191,1983,True,Knocked Out
Philadelphia 76ers,3600,7212,49.9,3575,7103,50.3,25,109,22.900000000000002,1966,2650,1334,3930,2016,1627,9191,1983,True,Champion
Chicago Bulls,3537,7373,48.0,3492,7164,48.699999999999996,45,209,21.5,1983,2690,1267,3794,2086,1743,9102,1983,False,Never Qualified
Oklahoma City Thunder,3597,7277,49.4,3568,7139,50.0,29,138,21.0,1796,2459,1152,3721,2278,1533,9019,1983,True,Knocked Out
Utah Jazz,3525,7342,48.0,3481,7159,48.6,44,183,24.0,1844,2440,1093,3643,2176,1683,8938,1983,False,Never Qualified
Indiana Pacers,3707,7723,48.0,3657,7487,48.8,50,236,21.2,1447,1910,1299,3593,2150,1535,8911,1983,False,Never Qualified
Golden State Warriors,3627,7508,48.3,3593,7358,48.8,34,150,22.7,1620,2199,1281,3565,1964,1606,8908,1983,False,Never Qualified
Los Angeles Clippers,3625,7634,47.5,3561,7372,48.3,64,262,24.4,1589,2195,1394,3502,2087,1600,8903,1983,False,Never Qualified
Portland Trail Blazers,3459,7124,48.6,3424,6974,49.1,35,150,23.3,1855,2512,1180,3560,2030,1495,8808,1983,True,Knocked Out
Phoenix Suns,3555,7158,49.7,3515,7000,50.2,40,158,25.3,1626,2189,1094,3612,2300,1545,8776,1983,True,Knocked Out
Milwaukee Bucks,3486,7133,48.9,3449,6964,49.5,37,169,21.9,1731,2299,1095,3572,2116,1447,8740,1983,True,Knocked Out
Brooklyn Nets,3510,7140,49.2,3480,6991,49.8,30,149,20.1,1622,2301,1266,3693,2143,1873,8672,1983,True,Knocked Out
Atlanta Hawks,3352,7146,46.9,3307,6958,47.5,45,188,23.9,1586,2111,1139,3572,1945,1424,8335,1983,True,Knocked Out
New York Knicks,3272,6793,48.199999999999996,3239,6662,48.6,33,131,25.2,1621,2282,1080,3343,2034,1509,8198,1983,True,Knocked Out
Houston Rockets,3338,7446,44.800000000000004,3271,7175,45.6,67,271,24.7,1402,1934,1206,3466,1931,1571,8145,1983,False,Never Qualified
Washington Wizards,3306,7059,46.800000000000004,3236,6822,47.4,70,237,29.5,1452,2059,1099,3529,2046,1588,8134,1983,False,Never Qualified
Cleveland Cavaliers,3252,6995,46.5,3222,6875,46.9,30,120,25.0,1430,1983,1173,3587,1738,1538,7964,1983,False,Never Qualified
Denver Nuggets,3935,7983,49.3,3858,7728,49.9,77,255,30.2,2200,2690,1133,3577,2482,1344,10147,1984,True,Knocked Out
San Antonio Spurs,3909,7721,50.6,3830,7458,51.4,79,263,30.0,1965,2604,1230,3758,2361,1447,9862,1984,False,Never Qualified
Detroit Pistons,3798,7910,48.0,3766,7769,48.5,32,141,22.7,1974,2547,1427,3861,2256,1310,9602,1984,True,Knocked Out
Los Angeles Lakers,3854,7250,53.2,3796,7024,54.0,58,226,25.7,1712,2272,1095,3594,2455,1578,9478,1984,True,Runner-Up
Utah Jazz,3606,7242,49.8,3505,6925,50.6,101,317,31.900000000000002,2115,2708,1096,3618,2230,1510,9428,1984,True,Knocked Out
Portland Trail Blazers,3632,7189,50.5,3607,7060,51.1,25,129,19.400000000000002,1988,2637,1251,3445,2082,1483,9277,1984,True,Knocked Out
Boston Celtics,3616,7235,50.0,3561,7006,50.8,55,229,24.0,1907,2407,1159,3697,2122,1420,9194,1984,True,Champion
Phoenix Suns,3677,7220,50.9,3603,6929,52.0,74,291,25.4,1673,2204,1066,3364,2214,1451,9101,1984,True,Knocked Out
Los Angeles Clippers,3634,7325,49.6,3610,7197,50.2,24,128,18.8,1785,2424,1307,3689,1981,1515,9077,1984,False,Never Qualified
Houston Rockets,3729,7533,49.5,3699,7379,50.1,30,154,19.5,1583,2139,1200,3683,2204,1562,9071,1984,False,Never Qualified
Dallas Mavericks,3618,7235,50.0,3576,7051,50.7,42,184,22.8,1774,2350,1090,3355,2164,1303,9052,1984,True,Knocked Out
Sacramento Kings,3516,7230,48.6,3464,7041,49.2,52,189,27.500000000000004,1939,2495,1144,3417,2229,1504,9023,1984,True,Knocked Out
Brooklyn Nets,3614,7258,49.8,3565,7026,50.7,49,232,21.099999999999998,1742,2488,1221,3534,2148,1608,9019,1984,True,Knocked Out
Golden State Warriors,3519,7534,46.7,3464,7308,47.4,55,226,24.3,1915,2577,1390,3561,1837,1518,9008,1984,False,Never Qualified
Oklahoma City Thunder,3460,7083,48.8,3433,6943,49.4,27,140,19.3,1918,2460,1064,3396,2233,1360,8865,1984,True,Knocked Out
Philadelphia 76ers,3384,6833,49.5,3355,6726,49.9,29,107,27.1,2041,2706,1181,3563,2032,1628,8838,1984,True,Knocked Out
New York Knicks,3386,6837,49.5,3339,6672,50.0,47,165,28.499999999999996,1944,2510,1088,3318,2041,1587,8763,1984,True,Knocked Out
Milwaukee Bucks,3432,6970,49.2,3373,6738,50.1,59,232,25.4,1743,2354,1135,3520,2113,1415,8666,1984,True,Knocked Out
Indiana Pacers,3447,7130,48.3,3399,6923,49.1,48,207,23.200000000000003,1624,2119,1002,3400,2169,1525,8566,1984,False,Never Qualified
Chicago Bulls,3305,6972,47.4,3285,6855,47.9,20,117,17.1,1871,2508,1141,3441,2095,1578,8501,1984,False,Never Qualified
Washington Wizards,3344,6907,48.4,3273,6625,49.4,71,282,25.2,1664,2201,1027,3414,2192,1448,8423,1984,True,Knocked Out
Cleveland Cavaliers,3362,7232,46.5,3319,7068,47.0,43,164,26.200000000000003,1619,2178,1213,3601,1930,1332,8386,1984,False,Never Qualified
Atlanta Hawks,3230,6809,47.4,3207,6703,47.8,23,106,21.7,1838,2414,1112,3344,1827,1329,8321,1984,True,Knocked Out
Denver Nuggets,3876,7976,48.6,3803,7741,49.1,73,235,31.1,2016,2568,1331,3634,2266,1382,9841,1985,True,Knocked Out
Los Angeles Lakers,3952,7254,54.50000000000001,3862,6959,55.50000000000001,90,295,30.5,1702,2232,1063,3613,2575,1537,9696,1985,True,Champion
Detroit Pistons,3840,7999,48.0,3795,7800,48.699999999999996,45,199,22.6,1783,2262,1403,3937,2302,1341,9508,1985,True,Knocked Out
Portland Trail Blazers,3708,7374,50.3,3657,7172,51.0,51,202,25.2,2002,2667,1202,3500,2225,1481,9469,1985,True,Knocked Out
Sacramento Kings,3664,7275,50.4,3601,7037,51.2,63,238,26.5,2022,2595,1167,3494,2342,1593,9413,1985,False,Never Qualified
Boston Celtics,3721,7325,50.8,3611,7016,51.5,110,309,35.6,1860,2307,1116,3746,2287,1332,9412,1985,True,Runner-Up
San Antonio Spurs,3698,7202,51.300000000000004,3643,7000,52.0,55,202,27.200000000000003,1961,2571,1127,3597,2316,1542,9412,1985,True,Knocked Out
Philadelphia 76ers,3443,6992,49.2,3384,6768,50.0,59,224,26.3,2316,2883,1301,3665,1999,1575,9261,1985,True,Knocked Out
Houston Rockets,3748,7440,50.4,3707,7254,51.1,41,186,22.0,1581,2261,1325,3720,2239,1605,9118,1985,True,Knocked Out
Dallas Mavericks,3560,7280,48.9,3408,6837,49.8,152,443,34.300000000000004,1844,2324,1095,3440,2152,1184,9116,1985,True,Knocked Out
Milwaukee Bucks,3564,7256,49.1,3475,6962,49.9,89,294,30.3,1873,2473,1256,3609,2164,1382,9090,1985,True,Knocked Out
Golden State Warriors,3498,7555,46.300000000000004,3386,7158,47.3,112,397,28.199999999999996,1944,2531,1327,3466,1759,1460,9052,1985,False,Never Qualified
Brooklyn Nets,3646,7445,49.0,3594,7221,49.8,52,224,23.200000000000003,1631,2237,1233,3558,2163,1355,8975,1985,True,Knocked Out
Utah Jazz,3478,7302,47.599999999999994,3375,6995,48.199999999999996,103,307,33.6,1878,2434,1081,3635,2143,1575,8937,1985,True,Knocked Out
Chicago Bulls,3453,6909,50.0,3424,6748,50.7,29,161,18.0,1981,2526,1074,3440,1992,1463,8916,1985,True,Knocked Out
Cleveland Cavaliers,3470,7364,47.099999999999994,3374,7029,48.0,96,335,28.7,1867,2491,1203,3648,2096,1387,8903,1985,True,Knocked Out
Indiana Pacers,3489,7324,47.599999999999994,3459,7169,48.199999999999996,30,155,19.400000000000002,1871,2516,1198,3821,1945,1622,8879,1985,False,Never Qualified
Phoenix Suns,3507,7144,49.1,3420,6837,50.0,87,307,28.299999999999997,1757,2280,1026,3451,2335,1583,8858,1985,True,Knocked Out
Los Angeles Clippers,3527,7119,49.5,3471,6931,50.1,56,188,29.799999999999997,1674,2208,1163,3597,1934,1587,8784,1985,False,Never Qualified
Atlanta Hawks,3444,7119,48.4,3371,6884,49.0,73,235,31.1,1782,2371,1161,3506,2009,1475,8743,1985,False,Never Qualified
Washington Wizards,3534,7383,47.9,3425,6985,49.0,109,398,27.400000000000002,1478,1989,1012,3407,2088,1282,8655,1985,True,Knocked Out
New York Knicks,3435,7101,48.4,3384,6903,49.0,51,198,25.8,1706,2350,1116,3218,1999,1458,8627,1985,False,Never Qualified
Oklahoma City Thunder,3277,6910,47.4,3232,6725,48.1,45,185,24.3,1777,2305,1019,3306,2185,1493,8376,1985,False,Never Qualified
Los Angeles Lakers,3834,7343,52.2,3696,6934,53.300000000000004,138,409,33.7,1812,2329,1101,3656,2433,1467,9618,1986,True,Knocked Out
Dallas Mavericks,3631,7254,50.1,3490,6808,51.300000000000004,141,446,31.6,2050,2643,1059,3513,2108,1289,9453,1986,True,Knocked Out
Portland Trail Blazers,3610,7281,49.6,3536,7006,50.5,74,275,26.900000000000002,2142,2799,1153,3469,2180,1529,9436,1986,True,Knocked Out
Denver Nuggets,3705,7868,47.099999999999994,3634,7563,48.0,71,305,23.3,1929,2416,1223,3540,2140,1336,9410,1986,True,Knocked Out
Milwaukee Bucks,3601,7310,49.3,3476,6928,50.2,125,382,32.7,2063,2701,1189,3609,2158,1369,9390,1986,True,Knocked Out
Houston Rockets,3759,7671,49.0,3674,7361,49.9,85,310,27.400000000000002,1776,2434,1316,3750,2318,1374,9379,1986,True,Runner-Up
Detroit Pistons,3754,7750,48.4,3699,7568,48.9,55,182,30.2,1800,2300,1276,3737,2319,1343,9363,1986,True,Knocked Out
Boston Celtics,3718,7312,50.8,3580,6919,51.7,138,393,35.099999999999994,1785,2248,1054,3807,2387,1360,9359,1986,True,Champion
Golden State Warriors,3650,7567,48.199999999999996,3563,7289,48.9,87,278,31.3,1912,2517,1271,3615,2018,1400,9299,1986,False,Never Qualified
San Antonio Spurs,3596,7104,50.6,3550,6908,51.4,46,196,23.5,1882,2523,1069,3482,2260,1624,9120,1986,True,Knocked Out
Philadelphia 76ers,3435,7058,48.699999999999996,3384,6834,49.5,51,224,22.8,2130,2810,1326,3704,2017,1595,9051,1986,True,Knocked Out
Phoenix Suns,3518,6993,50.3,3480,6810,51.1,38,183,20.8,1949,2683,1034,3483,2272,1763,9023,1986,False,Never Qualified
Chicago Bulls,3476,7227,48.1,3388,6910,49.0,88,317,27.800000000000004,1922,2499,1280,3558,2006,1436,8962,1986,True,Knocked Out
Brooklyn Nets,3548,7301,48.6,3505,7087,49.5,43,214,20.1,1810,2396,1183,3666,2128,1575,8949,1986,True,Knocked Out
Sacramento Kings,3538,7220,49.0,3508,7086,49.5,30,134,22.400000000000002,1818,2338,1135,3512,2304,1533,8924,1986,True,Knocked Out
Los Angeles Clippers,3388,7165,47.3,3324,6936,47.9,64,229,27.900000000000002,2067,2683,1159,3417,1968,1506,8907,1986,False,Never Qualified
Atlanta Hawks,3447,7029,49.0,3414,6863,49.7,33,166,19.900000000000002,1979,2704,1249,3654,2025,1483,8906,1986,True,Knocked Out
Utah Jazz,3453,7083,48.8,3418,6914,49.4,35,169,20.7,1930,2694,1068,3547,2199,1518,8871,1986,True,Knocked Out
Cleveland Cavaliers,3478,7239,48.0,3346,6848,48.9,132,391,33.800000000000004,1748,2325,1086,3541,2064,1411,8836,1986,False,Never Qualified
Oklahoma City Thunder,3335,7059,47.199999999999996,3256,6759,48.199999999999996,79,300,26.3,1815,2331,1145,3401,1977,1435,8564,1986,False,Never Qualified
Indiana Pacers,3441,7150,48.1,3418,7007,48.8,23,143,16.1,1614,2183,1138,3751,2159,1515,8519,1986,False,Never Qualified
Washington Wizards,3311,7148,46.300000000000004,3195,6740,47.4,116,408,28.4,1704,2286,1066,3498,1748,1346,8442,1986,True,Knocked Out
New York Knicks,3239,7034,46.0,3157,6795,46.5,82,239,34.300000000000004,1534,2237,1081,3251,1877,1438,8094,1986,False,Never Qualified
Portland Trail Blazers,3650,7249,50.4,3552,6910,51.4,98,339,28.9,2269,2928,1180,3593,2359,1546,9667,1987,True,Knocked Out
Los Angeles Lakers,3740,7245,51.6,3576,6798,52.6,164,447,36.7,2012,2550,1127,3642,2428,1358,9656,1987,True,Champion
Denver Nuggets,3744,7951,47.099999999999994,3638,7560,48.1,106,391,27.1,1975,2568,1294,3662,2317,1216,9569,1987,True,Knocked Out
Dallas Mavericks,3594,7373,48.699999999999996,3363,6720,50.0,231,653,35.4,2148,2717,1219,3713,2017,1205,9567,1987,True,Knocked Out
Oklahoma City Thunder,3593,7451,48.199999999999996,3402,6880,49.4,191,571,33.5,1948,2571,1373,3768,2184,1509,9325,1987,True,Knocked Out
Boston Celtics,3645,7051,51.7,3438,6486,53.0,207,565,36.6,1740,2153,933,3518,2421,1300,9237,1987,True,Runner-Up
Golden State Warriors,3551,7412,47.9,3435,7048,48.699999999999996,116,364,31.900000000000002,1970,2526,1193,3544,2083,1354,9188,1987,True,Knocked Out
Detroit Pistons,3544,7237,49.0,3505,7068,49.6,39,169,23.1,1991,2602,1245,3894,2021,1417,9118,1987,True,Knocked Out
Phoenix Suns,3575,7190,49.7,3514,6938,50.6,61,252,24.2,1900,2499,1113,3479,2354,1498,9111,1987,False,Never Qualified
Sacramento Kings,3522,7413,47.5,3445,7106,48.5,77,307,25.1,1974,2479,1282,3723,2185,1403,9095,1987,False,Never Qualified
Milwaukee Bucks,3457,7282,47.5,3272,6710,48.8,185,572,32.300000000000004,1953,2549,1119,3441,2044,1260,9052,1987,True,Knocked Out
Atlanta Hawks,3435,7141,48.1,3300,6716,49.1,135,425,31.8,2019,2661,1350,3828,2077,1279,9024,1987,True,Knocked Out
Brooklyn Nets,3374,7083,47.599999999999994,3229,6634,48.699999999999996,145,449,32.300000000000004,2000,2607,1169,3578,1991,1617,8893,1987,False,Never Qualified
San Antonio Spurs,3532,7456,47.4,3415,7053,48.4,117,403,28.999999999999996,1701,2292,1285,3632,2220,1406,8882,1987,False,Never Qualified
Utah Jazz,3485,7514,46.400000000000006,3346,7066,47.4,139,448,31.0,1735,2389,1194,3650,2240,1403,8844,1987,True,Knocked Out
Houston Rockets,3465,7262,47.699999999999996,3376,6938,48.699999999999996,89,324,27.500000000000004,1746,2355,1190,3671,2227,1384,8765,1987,True,Knocked Out
Philadelphia 76ers,3335,6792,49.1,3247,6452,50.3,88,340,25.900000000000002,1971,2617,1178,3505,1943,1519,8729,1987,True,Knocked Out
Indiana Pacers,3454,7324,47.199999999999996,3360,7008,47.9,94,316,29.7,1696,2170,1132,3596,2170,1276,8698,1987,True,Knocked Out
Washington Wizards,3356,7397,45.4,3313,7179,46.1,43,218,19.7,1935,2531,1305,3620,1750,1301,8690,1987,True,Knocked Out
Chicago Bulls,3382,7155,47.3,3304,6856,48.199999999999996,78,299,26.1,1754,2254,1248,3648,2143,1257,8596,1987,True,Knocked Out
Los Angeles Clippers,3311,7332,45.2,3233,6984,46.300000000000004,78,348,22.400000000000002,1866,2515,1231,3368,1971,1493,8566,1987,False,Never Qualified
Cleveland Cavaliers,3349,7122,47.0,3268,6784,48.199999999999996,81,338,24.0,1779,2554,1257,3677,1912,1619,8558,1987,False,Never Qualified
New York Knicks,3329,7023,47.4,3204,6648,48.199999999999996,125,375,33.300000000000004,1725,2362,1108,3270,1941,1420,8508,1987,False,Never Qualified
Denver Nuggets,3770,7961,47.4,3578,7399,48.4,192,562,34.2,1841,2289,1163,3605,2300,1186,9573,1988,True,Knocked Out
Portland Trail Blazers,3661,7460,49.1,3544,7080,50.1,117,380,30.8,2079,2701,1251,3742,2307,1351,9518,1988,True,Knocked Out
Boston Celtics,3599,6905,52.1,3328,6200,53.7,271,705,38.4,1846,2300,930,3370,2448,1304,9315,1988,True,Knocked Out
San Antonio Spurs,3706,7559,49.0,3573,7147,50.0,133,412,32.300000000000004,1769,2412,1184,3519,2344,1418,9314,1988,True,Knocked Out
Los Angeles Lakers,3576,7078,50.5,3434,6600,52.0,142,478,29.7,1956,2480,1073,3564,2347,1318,9250,1988,True,Champion
Oklahoma City Thunder,3544,7443,47.599999999999994,3323,6805,48.8,221,638,34.599999999999994,1826,2442,1313,3627,2146,1376,9135,1988,True,Knocked Out
Dallas Mavericks,3413,7191,47.5,3259,6665,48.9,154,526,29.299999999999997,1980,2510,1341,3836,1984,1257,8960,1988,True,Knocked Out
Detroit Pistons,3461,7018,49.3,3403,6816,49.9,58,202,28.7,1977,2612,1181,3663,2011,1348,8957,1988,True,Runner-Up
Houston Rockets,3465,7354,47.099999999999994,3396,7063,48.1,69,291,23.7,1936,2483,1239,3769,1936,1367,8935,1988,True,Knocked Out
Phoenix Suns,3551,7302,48.6,3433,6945,49.4,118,357,33.1,1681,2200,1113,3492,2332,1413,8901,1988,False,Never Qualified
Utah Jazz,3484,7092,49.1,3355,6688,50.2,129,404,31.900000000000002,1802,2404,1066,3619,2407,1481,8899,1988,True,Knocked Out
Sacramento Kings,3458,7337,47.099999999999994,3314,6887,48.1,144,450,32.0,1795,2324,1232,3693,2116,1457,8855,1988,False,Never Qualified
Atlanta Hawks,3443,7102,48.5,3358,6820,49.2,85,282,30.099999999999998,1873,2441,1228,3607,2062,1225,8844,1988,True,Knocked Out
Golden State Warriors,3463,7404,46.800000000000004,3372,7092,47.5,91,312,29.2,1754,2204,1140,3392,2005,1395,8771,1988,False,Never Qualified
Milwaukee Bucks,3366,7079,47.5,3233,6669,48.5,133,410,32.4,1832,2364,1117,3452,2194,1275,8697,1988,True,Knocked Out
Philadelphia 76ers,3214,6785,47.4,3062,6314,48.5,152,471,32.300000000000004,2087,2731,1219,3526,1897,1433,8667,1988,False,Never Qualified
New York Knicks,3363,7232,46.5,3184,6665,47.8,179,567,31.6,1750,2306,1286,3480,2012,1518,8655,1988,True,Knocked Out
Washington Wizards,3355,7164,46.800000000000004,3326,7026,47.3,29,138,21.0,1914,2476,1229,3526,1875,1384,8653,1988,True,Knocked Out
Chicago Bulls,3434,7015,49.0,3378,6772,49.9,56,243,23.0,1685,2221,1170,3629,2149,1263,8609,1988,True,Knocked Out
Indiana Pacers,3436,7154,48.0,3273,6669,49.1,163,485,33.6,1546,1982,1078,3535,1977,1318,8581,1988,False,Never Qualified
Cleveland Cavaliers,3313,6755,49.0,3186,6419,49.6,127,336,37.8,1813,2438,1015,3304,2070,1439,8566,1988,True,Knocked Out
Brooklyn Nets,3208,6857,46.800000000000004,3071,6402,48.0,137,455,30.099999999999998,1682,2308,1075,3337,1795,1503,8235,1988,False,Never Qualified
Los Angeles Clippers,3190,7194,44.3,3111,6877,45.2,79,317,24.9,1644,2305,1191,3541,1885,1534,8103,1988,False,Never Qualified
Phoenix Suns,3754,7545,49.8,3586,7064,50.8,168,481,34.9,2051,2594,1095,3714,2280,1279,9727,1989,True,Knocked Out
Denver Nuggets,3813,8140,46.800000000000004,3585,7464,48.0,228,676,33.7,1821,2314,1206,3719,2282,1225,9675,1989,True,Knocked Out
New York Knicks,3701,7611,48.6,3315,6464,51.300000000000004,386,1147,33.7,1779,2366,1322,3587,2083,1572,9567,1989,True,Knocked Out
Golden State Warriors,3730,7977,46.800000000000004,3536,7348,48.1,194,629,30.8,1904,2384,1323,3884,2009,1488,9558,1989,True,Knocked Out
Los Angeles Lakers,3584,7143,50.2,3357,6476,51.800000000000004,227,667,34.0,2011,2508,1094,3706,2282,1344,9406,1989,True,Runner-Up
Portland Trail Blazers,3695,7795,47.4,3479,7150,48.699999999999996,216,645,33.5,1789,2416,1384,3765,2212,1435,9395,1989,True,Knocked Out
Oklahoma City Thunder,3564,7478,47.699999999999996,3271,6704,48.8,293,774,37.9,1775,2379,1397,3635,2083,1403,9196,1989,True,Knocked Out
Philadelphia 76ers,3500,7201,48.6,3296,6555,50.3,204,646,31.6,1970,2504,1143,3499,2110,1214,9174,1989,True,Knocked Out
Atlanta Hawks,3412,7230,47.199999999999996,3302,6833,48.3,110,397,27.700000000000003,2168,2709,1372,3688,1990,1310,9102,1989,True,Knocked Out
Boston Celtics,3520,7143,49.3,3442,6834,50.4,78,309,25.2,1840,2349,1179,3621,2189,1336,8958,1989,True,Knocked Out
Milwaukee Bucks,3399,7167,47.4,3220,6600,48.8,179,567,31.6,1955,2382,1133,3405,2071,1305,8932,1989,True,Knocked Out
Cleveland Cavaliers,3466,6904,50.2,3296,6430,51.300000000000004,170,474,35.9,1821,2438,1033,3508,2260,1323,8923,1989,True,Knocked Out
Houston Rockets,3412,7196,47.4,3248,6673,48.699999999999996,164,523,31.4,1909,2527,1211,3765,2016,1569,8897,1989,True,Knocked Out
Washington Wizards,3519,7591,46.400000000000006,3467,7348,47.199999999999996,52,243,21.4,1789,2318,1254,3608,2048,1291,8879,1989,False,Never Qualified
Indiana Pacers,3385,6945,48.699999999999996,3183,6330,50.3,202,615,32.800000000000004,1795,2275,1065,3562,2012,1547,8767,1989,False,Never Qualified
Detroit Pistons,3395,6879,49.4,3275,6479,50.5,120,400,30.0,1830,2379,1154,3700,2027,1336,8740,1989,True,Champion
Chicago Bulls,3448,6968,49.5,3274,6438,50.9,174,530,32.800000000000004,1656,2106,1018,3471,2213,1327,8726,1989,True,Knocked Out
Los Angeles Clippers,3526,7428,47.5,3472,7194,48.3,54,234,23.1,1606,2220,1156,3540,2208,1666,8712,1989,False,Never Qualified
San Antonio Spurs,3469,7409,46.800000000000004,3406,7116,47.9,63,293,21.5,1651,2367,1295,3476,2037,1712,8652,1989,False,Never Qualified
Sacramento Kings,3362,7351,45.7,3055,6527,46.800000000000004,307,824,37.3,1620,2104,1141,3595,1970,1370,8651,1989,False,Never Qualified
Utah Jazz,3182,6595,48.199999999999996,3068,6215,49.4,114,380,30.0,2110,2742,1050,3657,2108,1532,8588,1989,True,Knocked Out
Charlotte Hornets,3426,7430,46.1,3292,7000,47.0,134,430,31.2,1580,2060,1138,3338,2323,1318,8566,1989,False,Never Qualified
Brooklyn Nets,3333,7226,46.1,3146,6658,47.3,187,568,32.9,1653,2260,1204,3623,1793,1449,8506,1989,False,Never Qualified
Dallas Mavericks,3244,6917,46.9,3033,6236,48.6,211,681,31.0,1785,2263,1048,3445,1867,1233,8484,1989,False,Never Qualified
Miami Heat,3221,7116,45.300000000000004,3124,6818,45.800000000000004,97,298,32.6,1477,2103,1309,3520,1958,1728,8016,1989,False,Never Qualified
Golden State Warriors,3489,7208,48.4,3246,6458,50.3,243,750,32.4,2313,2858,915,3300,1978,1415,9534,1990,False,Never Qualified
Phoenix Suns,3544,7139,49.6,3368,6596,51.1,176,543,32.4,2159,2716,1053,3704,2109,1275,9423,1990,True,Knocked Out
Denver Nuggets,3716,8015,46.400000000000006,3488,7338,47.5,228,677,33.7,1737,2201,1169,3701,2275,1136,9397,1990,True,Knocked Out
Portland Trail Blazers,3572,7547,47.3,3382,6982,48.4,190,565,33.6,2031,2734,1355,3907,2085,1356,9365,1990,True,Runner-Up
Orlando Magic,3457,7525,45.9,3341,7132,46.800000000000004,116,393,29.5,2060,2725,1304,3769,1993,1407,9090,1990,False,Never Qualified
Los Angeles Lakers,3434,7010,49.0,3125,6169,50.7,309,841,36.7,1902,2417,1097,3557,2232,1226,9079,1990,True,Knocked Out
Philadelphia 76ers,3437,7028,48.9,3248,6485,50.1,189,543,34.8,1976,2509,1111,3517,1932,1209,9039,1990,True,Knocked Out
Boston Celtics,3563,7148,49.8,3457,6744,51.300000000000004,106,404,26.200000000000003,1791,2153,1066,3773,2423,1256,9023,1990,True,Knocked Out
Chicago Bulls,3531,7090,49.8,3281,6421,51.1,250,669,37.4,1665,2140,1075,3354,2172,1247,8977,1990,True,Knocked Out
Indiana Pacers,3381,6807,49.7,3087,6037,51.1,294,770,38.2,1906,2335,940,3328,2023,1342,8962,1990,True,Knocked Out
Atlanta Hawks,3417,7019,48.699999999999996,3293,6608,49.8,124,411,30.2,1943,2544,1273,3460,1820,1270,8901,1990,False,Never Qualified
New York Knicks,3434,7089,48.4,3198,6379,50.1,236,710,33.2,1775,2349,1187,3613,2140,1412,8879,1990,True,Knocked Out
Washington Wizards,3598,7581,47.5,3561,7384,48.199999999999996,37,197,18.8,1599,2093,1198,3648,2214,1201,8832,1990,False,Never Qualified
Oklahoma City Thunder,3466,7243,47.9,3235,6593,49.1,231,650,35.5,1606,2167,1323,3578,1874,1336,8769,1990,False,Never Qualified
Utah Jazz,3330,6593,50.5,3104,5963,52.1,226,630,35.9,1874,2484,953,3454,2212,1410,8760,1990,True,Knocked Out
Houston Rockets,3483,7250,48.0,3330,6759,49.3,153,491,31.2,1633,2267,1217,3855,2194,1513,8752,1990,True,Knocked Out
San Antonio Spurs,3388,6997,48.4,3334,6771,49.2,54,226,23.9,1888,2535,1163,3637,2037,1399,8718,1990,True,Knocked Out
Milwaukee Bucks,3380,7146,47.3,3171,6476,49.0,209,670,31.2,1722,2273,1108,3354,2046,1315,8691,1990,True,Knocked Out
Detroit Pistons,3333,6980,47.8,3156,6439,49.0,177,541,32.7,1713,2252,1185,3643,1996,1233,8556,1990,True,Champion
Los Angeles Clippers,3319,6853,48.4,3263,6623,49.3,56,230,24.3,1815,2458,1056,3418,1978,1547,8509,1990,False,Never Qualified
Cleveland Cavaliers,3214,6977,46.1,2868,6126,46.800000000000004,346,851,40.699999999999996,1637,2201,1128,3508,2106,1243,8411,1990,True,Knocked Out
Dallas Mavericks,3246,6831,47.5,3089,6345,48.699999999999996,157,486,32.300000000000004,1735,2261,1042,3461,1776,1228,8384,1990,True,Knocked Out
Sacramento Kings,3305,7056,46.800000000000004,3089,6407,48.199999999999996,216,649,33.300000000000004,1515,1964,952,3315,2052,1239,8341,1990,False,Never Qualified
Miami Heat,3383,7345,46.1,3295,7045,46.800000000000004,88,300,29.299999999999997,1393,2028,1242,3555,1957,1557,8247,1990,False,Never Qualified
Charlotte Hornets,3270,7183,45.5,3065,6572,46.6,205,611,33.6,1487,1967,962,3173,2080,1226,8232,1990,False,Never Qualified
Brooklyn Nets,3157,7415,42.6,3017,6909,43.7,140,506,27.700000000000003,1754,2350,1363,3687,1475,1360,8208,1990,False,Never Qualified
Minnesota Timberwolves,3067,6876,44.6,2994,6582,45.5,73,294,24.8,1596,2137,1196,3249,1844,1197,7803,1990,False,Never Qualified
Denver Nuggets,3901,8868,44.0,3601,7809,46.1,300,1059,28.299999999999997,1726,2263,1520,4050,2005,1332,9828,1991,False,Never Qualified
Golden State Warriors,3566,7346,48.5,3296,6545,50.4,270,801,33.7,2162,2761,1113,3419,1954,1359,9564,1991,True,Knocked Out
Portland Trail Blazers,3577,7369,48.5,3236,6465,50.1,341,904,37.7,1912,2538,1202,3763,2254,1309,9407,1991,True,Knocked Out
Phoenix Suns,3573,7199,49.6,3435,6767,50.8,138,432,31.900000000000002,2064,2680,1132,3730,2209,1302,9348,1991,True,Knocked Out
Indiana Pacers,3450,6994,49.3,3201,6245,51.300000000000004,249,749,33.2,2010,2479,1018,3394,2181,1355,9159,1991,True,Knocked Out
Boston Celtics,3695,7214,51.2,3586,6868,52.2,109,346,31.5,1646,1997,1088,3785,2160,1320,9145,1991,True,Knocked Out
Chicago Bulls,3632,7125,51.0,3477,6701,51.9,155,424,36.6,1605,2111,1148,3490,2212,1184,9024,1991,True,Champion
Atlanta Hawks,3349,7223,46.400000000000006,3078,6387,48.199999999999996,271,836,32.4,2034,2544,1235,3655,1864,1231,9003,1991,True,Knocked Out
San Antonio Spurs,3409,6988,48.8,3328,6691,49.7,81,297,27.3,1883,2459,1131,3788,2140,1445,8782,1991,True,Knocked Out
Houston Rockets,3403,7287,46.7,3087,6298,49.0,316,989,32.0,1631,2200,1275,3783,1906,1402,8753,1991,True,Knocked Out
Oklahoma City Thunder,3500,7117,49.2,3364,6690,50.3,136,427,31.900000000000002,1608,2143,1222,3395,2042,1404,8744,1991,True,Knocked Out
Milwaukee Bucks,3337,6948,48.0,3080,6195,49.7,257,753,34.1,1796,2241,1079,3241,2075,1321,8727,1991,True,Knocked Out
Los Angeles Lakers,3343,6911,48.4,3117,6167,50.5,226,744,30.4,1805,2261,1078,3518,2091,1203,8717,1991,True,Runner-Up
Orlando Magic,3298,7256,45.5,3028,6502,46.6,270,754,35.8,1818,2447,1233,3662,1809,1391,8684,1991,False,Never Qualified
Philadelphia 76ers,3289,6925,47.5,3094,6307,49.1,195,618,31.6,1868,2366,984,3480,1824,1230,8641,1991,True,Knocked Out
Utah Jazz,3214,6537,49.2,3066,6079,50.4,148,458,32.300000000000004,1951,2472,867,3341,2217,1305,8527,1991,True,Knocked Out
Los Angeles Clippers,3391,7315,46.400000000000006,3278,6881,47.599999999999994,113,434,26.0,1596,2273,1246,3746,2119,1438,8491,1991,False,Never Qualified
New York Knicks,3308,6822,48.5,3123,6264,49.9,185,558,33.2,1654,2147,1053,3489,2172,1379,8455,1991,True,Knocked Out
Brooklyn Nets,3311,7459,44.4,3150,6873,45.800000000000004,161,586,27.500000000000004,1658,2245,1400,3748,1782,1423,8441,1991,False,Never Qualified
Charlotte Hornets,3286,7033,46.7,3155,6616,47.699999999999996,131,417,31.4,1725,2214,1027,3227,2019,1290,8428,1991,False,Never Qualified
Miami Heat,3280,7139,45.9,3140,6675,47.0,140,464,30.2,1649,2307,1232,3534,1904,1551,8349,1991,False,Never Qualified
Cleveland Cavaliers,3259,6857,47.5,3099,6378,48.6,160,479,33.4,1665,2176,1011,3340,2240,1281,8343,1991,False,Never Qualified
Washington Wizards,3390,7268,46.6,3335,6984,47.8,55,284,19.400000000000002,1478,2028,1173,3563,2081,1359,8313,1991,False,Never Qualified
Detroit Pistons,3194,6875,46.5,3063,6435,47.599999999999994,131,440,29.799999999999997,1686,2211,1206,3658,1825,1181,8205,1991,True,Knocked Out
Dallas Mavericks,3245,6890,47.099999999999994,3052,6290,48.5,193,600,32.2,1512,1986,984,3344,1821,1186,8195,1991,False,Never Qualified
Minnesota Timberwolves,3265,7276,44.9,3157,6895,45.800000000000004,108,381,28.299999999999997,1531,2082,1275,3388,1885,1062,8169,1991,False,Never Qualified
Sacramento Kings,3086,6818,45.300000000000004,2870,6240,46.0,216,578,37.4,1540,2105,1027,3245,1991,1272,7928,1991,False,Never Qualified
Golden State Warriors,3767,7427,50.7,3513,6664,52.7,254,763,33.300000000000004,1944,2606,1137,3513,2064,1353,9732,1992,True,Knocked Out
Indiana Pacers,3498,7079,49.4,3165,6139,51.6,333,940,35.4,1868,2364,1083,3647,2398,1402,9197,1992,True,Knocked Out
Phoenix Suns,3553,7219,49.2,3326,6623,50.2,227,596,38.1,1861,2397,1088,3646,2202,1242,9194,1992,True,Knocked Out
Portland Trail Blazers,3476,7352,47.3,3151,6408,49.2,325,944,34.4,1858,2463,1294,3843,2065,1328,9135,1992,True,Runner-Up
Chicago Bulls,3643,7168,50.8,3505,6714,52.2,138,454,30.4,1587,2132,1173,3612,2279,1088,9011,1992,True,Champion
Charlotte Hornets,3613,7568,47.699999999999996,3496,7199,48.6,117,369,31.7,1637,2168,1164,3531,2284,1273,8980,1992,False,Never Qualified
Cleveland Cavaliers,3427,7025,48.8,3174,6317,50.2,253,708,35.699999999999996,1819,2259,1041,3491,2260,1073,8926,1992,True,Knocked Out
Utah Jazz,3379,6866,49.2,3221,6408,50.3,158,458,34.5,1961,2490,1097,3640,2188,1264,8877,1992,True,Knocked Out
Boston Celtics,3543,7196,49.2,3433,6837,50.2,110,359,30.599999999999998,1549,1917,1095,3678,2072,1165,8745,1992,True,Knocked Out
Oklahoma City Thunder,3380,7128,47.4,3175,6481,49.0,205,647,31.7,1772,2263,1282,3539,1877,1323,8737,1992,True,Knocked Out
Atlanta Hawks,3492,7476,46.7,3282,6805,48.199999999999996,210,671,31.3,1517,2074,1288,3786,2123,1255,8711,1992,False,Never Qualified
Brooklyn Nets,3473,7580,45.800000000000004,3249,6910,47.0,224,670,33.4,1471,2009,1512,3904,1937,1392,8641,1992,True,Knocked Out
Milwaukee Bucks,3321,7216,46.0,2950,6211,47.5,371,1005,36.9,1596,2104,1297,3469,2018,1350,8609,1992,False,Never Qualified
Miami Heat,3256,7061,46.1,2999,6310,47.5,257,751,34.2,1839,2329,1187,3553,1749,1377,8608,1992,True,Knocked Out
Sacramento Kings,3348,7189,46.6,3110,6514,47.699999999999996,238,675,35.3,1615,2162,1054,3408,1957,1360,8549,1992,False,Never Qualified
San Antonio Spurs,3377,7090,47.599999999999994,3259,6686,48.699999999999996,118,404,29.2,1652,2246,1229,3781,2010,1308,8524,1992,True,Knocked Out
Los Angeles Clippers,3347,7076,47.3,3202,6574,48.699999999999996,145,502,28.9,1601,2223,1132,3525,2053,1269,8440,1992,True,Knocked Out
Washington Wizards,3364,7301,46.1,3218,6764,47.599999999999994,146,537,27.200000000000003,1521,1956,1069,3414,2011,1254,8395,1992,False,Never Qualified
Houston Rockets,3273,6894,47.5,2944,5935,49.6,329,959,34.300000000000004,1491,2020,1074,3506,2058,1378,8366,1992,False,Never Qualified
Philadelphia 76ers,3187,6761,47.099999999999994,2960,6081,48.699999999999996,227,680,33.4,1757,2267,1058,3367,1755,1238,8358,1992,False,Never Qualified
Orlando Magic,3220,7102,45.300000000000004,3023,6494,46.6,197,608,32.4,1693,2268,1171,3500,1792,1389,8330,1992,False,Never Qualified
New York Knicks,3312,6947,47.699999999999996,3111,6329,49.2,201,618,32.5,1503,2049,1185,3674,2130,1242,8328,1992,True,Knocked Out
Minnesota Timberwolves,3366,7342,45.800000000000004,3240,6948,46.6,126,394,32.0,1379,1857,1167,3335,2025,1157,8237,1992,False,Never Qualified
Los Angeles Lakers,3183,6977,45.6,3064,6532,46.9,119,445,26.700000000000003,1744,2278,1156,3352,1803,1089,8229,1992,True,Knocked Out
Denver Nuggets,3262,7380,44.2,3136,6962,45.0,126,418,30.099999999999998,1526,2067,1350,3702,1553,1447,8176,1992,False,Never Qualified
Detroit Pistons,3191,6867,46.5,3026,6341,47.699999999999996,165,526,31.4,1566,2108,1210,3631,1899,1212,8113,1992,True,Knocked Out
Dallas Mavericks,3120,7104,43.9,2852,6307,45.2,268,797,33.6,1499,1999,1194,3633,1630,1202,8007,1992,False,Never Qualified
Phoenix Suns,3494,7093,49.3,3096,5998,51.6,398,1095,36.3,1912,2539,1141,3651,2087,1359,9298,1993,True,Runner-Up
Charlotte Hornets,3512,7210,48.699999999999996,3337,6673,50.0,175,537,32.6,1831,2374,1095,3603,2161,1325,9030,1993,True,Knocked Out
Golden State Warriors,3474,7212,48.199999999999996,3176,6360,49.9,298,852,35.0,1768,2465,1219,3603,2010,1451,9014,1993,False,Never Qualified
Portland Trail Blazers,3361,7343,45.800000000000004,3086,6500,47.5,275,843,32.6,1901,2551,1226,3733,1969,1215,8898,1993,True,Knocked Out
Oklahoma City Thunder,3473,7140,48.6,3255,6530,49.8,218,610,35.699999999999996,1720,2259,1222,3476,1906,1267,8884,1993,True,Knocked Out
Sacramento Kings,3360,7264,46.300000000000004,3098,6476,47.8,262,788,33.2,1865,2447,1137,3418,2075,1364,8847,1993,False,Never Qualified
Indiana Pacers,3371,7022,48.0,3114,6233,50.0,257,789,32.6,1837,2399,1220,3675,2144,1256,8836,1993,True,Knocked Out
Cleveland Cavaliers,3425,6887,49.7,3142,6145,51.1,283,742,38.1,1699,2119,929,3425,2349,1120,8832,1993,True,Knocked Out
Atlanta Hawks,3392,7272,46.6,3010,6196,48.6,382,1076,35.5,1648,2221,1290,3634,2084,1339,8814,1993,True,Knocked Out
Los Angeles Clippers,3544,7329,48.4,3411,6838,49.9,133,491,27.1,1562,2177,1183,3543,2242,1338,8783,1993,True,Knocked Out
Utah Jazz,3336,6828,48.9,3206,6414,50.0,130,414,31.4,1907,2491,1041,3504,2177,1270,8709,1993,True,Knocked Out
Orlando Magic,3257,6708,48.6,2940,5819,50.5,317,889,35.699999999999996,1821,2495,1040,3606,1952,1429,8652,1993,False,Never Qualified
San Antonio Spurs,3311,6762,49.0,3075,6070,50.7,236,692,34.1,1794,2346,919,3461,2012,1227,8652,1993,True,Knocked Out
Denver Nuggets,3352,7282,46.0,3214,6828,47.099999999999994,138,454,30.4,1784,2360,1266,3830,1735,1413,8626,1993,False,Never Qualified
Chicago Bulls,3475,7205,48.199999999999996,3231,6536,49.4,244,669,36.5,1431,1952,1290,3573,2133,1103,8625,1993,True,Champion
Philadelphia 76ers,3225,7075,45.6,2895,6134,47.199999999999996,330,941,35.099999999999994,1776,2259,1031,3462,2038,1362,8556,1993,False,Never Qualified
Los Angeles Lakers,3309,6994,47.3,3122,6368,49.0,187,626,29.9,1741,2304,1103,3391,2013,1266,8546,1993,True,Knocked Out
Houston Rockets,3280,6744,48.6,2893,5671,51.0,387,1073,36.1,1584,2090,985,3517,2115,1295,8531,1993,True,Knocked Out
Boston Celtics,3453,7093,48.699999999999996,3343,6710,49.8,110,383,28.7,1486,1912,1076,3512,1999,1174,8502,1993,True,Knocked Out
Miami Heat,3127,6850,45.6,2794,5910,47.3,333,940,35.4,1908,2476,1134,3518,1688,1287,8495,1993,False,Never Qualified
Brooklyn Nets,3272,7084,46.2,3117,6596,47.3,155,488,31.8,1732,2258,1291,3797,1872,1355,8431,1993,True,Knocked Out
Milwaukee Bucks,3268,6924,47.199999999999996,2956,5988,49.4,312,936,33.300000000000004,1544,2081,1050,3163,2084,1363,8392,1993,False,Never Qualified
Washington Wizards,3302,7065,46.7,3128,6487,48.199999999999996,174,578,30.099999999999998,1575,2107,1031,3348,2110,1323,8353,1993,False,Never Qualified
New York Knicks,3209,6898,46.5,3016,6294,47.9,193,604,32.0,1717,2316,1150,3810,2125,1296,8328,1993,True,Knocked Out
Detroit Pistons,3267,7211,45.300000000000004,2975,6303,47.199999999999996,292,908,32.2,1426,1957,1293,3608,1941,1152,8252,1993,False,Never Qualified
Dallas Mavericks,3164,7271,43.5,2881,6434,44.800000000000004,283,837,33.800000000000004,1530,2171,1234,3499,1683,1459,8141,1993,False,Never Qualified
Minnesota Timberwolves,3043,6529,46.6,2877,5960,48.3,166,569,29.2,1794,2247,940,3144,2001,1422,8046,1993,False,Never Qualified
Phoenix Suns,3429,7080,48.4,3085,6038,51.1,344,1042,33.0,1674,2301,1220,3673,2261,1305,8876,1994,True,Knocked Out
Golden State Warriors,3512,7145,49.2,3221,6286,51.2,291,859,33.900000000000006,1529,2304,1183,3579,2198,1433,8844,1994,True,Knocked Out
Portland Trail Blazers,3371,7427,45.4,3099,6657,46.6,272,770,35.3,1781,2396,1302,3762,2070,1210,8795,1994,True,Knocked Out
Charlotte Hornets,3382,7100,47.599999999999994,3046,6184,49.3,336,916,36.7,1632,2135,1019,3494,2214,1266,8732,1994,False,Never Qualified
Oklahoma City Thunder,3338,6901,48.4,3096,6179,50.1,242,722,33.5,1769,2374,1148,3381,2112,1262,8687,1994,True,Knocked Out
Orlando Magic,3341,6883,48.5,2947,5746,51.300000000000004,394,1137,34.699999999999996,1590,2346,1177,3533,2070,1327,8666,1994,True,Knocked Out
Miami Heat,3197,6896,46.400000000000006,2860,5899,48.5,337,997,33.800000000000004,1744,2223,1235,3642,1856,1315,8475,1994,True,Knocked Out
Brooklyn Nets,3169,7115,44.5,2946,6432,45.800000000000004,223,683,32.7,1900,2495,1300,3856,1900,1196,8461,1994,True,Knocked Out
Los Angeles Clippers,3343,7163,46.7,3091,6332,48.8,252,831,30.3,1509,2128,1120,3530,2169,1474,8447,1994,False,Never Qualified
Utah Jazz,3207,6729,47.699999999999996,3028,6170,49.1,179,559,32.0,1761,2379,1059,3444,2179,1191,8354,1994,True,Knocked Out
Atlanta Hawks,3247,7039,46.1,2979,6209,48.0,268,830,32.300000000000004,1556,2070,1250,3673,2056,1252,8318,1994,True,Knocked Out
Cleveland Cavaliers,3133,6731,46.5,2839,5918,48.0,294,813,36.199999999999996,1736,2254,1090,3443,2049,1136,8296,1994,True,Knocked Out
Houston Rockets,3197,6733,47.5,2768,5448,50.8,429,1285,33.4,1469,1978,926,3545,2087,1338,8292,1994,True,Champion
Sacramento Kings,3179,7027,45.2,2922,6298,46.400000000000006,257,729,35.3,1676,2292,1122,3471,2029,1333,8291,1994,False,Never Qualified
Indiana Pacers,3167,6516,48.6,2983,6016,49.6,184,500,36.8,1762,2387,1130,3539,2055,1440,8280,1994,True,Knocked Out
Boston Celtics,3333,7057,47.199999999999996,3195,6580,48.6,138,477,28.9,1463,2003,1037,3417,1928,1242,8267,1994,False,Never Qualified
Los Angeles Lakers,3291,7316,45.0,3050,6513,46.800000000000004,241,803,30.0,1410,1967,1260,3464,1983,1197,8233,1994,False,Never Qualified
Washington Wizards,3195,6826,46.800000000000004,2974,6082,48.9,221,744,29.7,1618,2162,1071,3260,1823,1403,8229,1994,False,Never Qualified
Denver Nuggets,3156,6781,46.5,2986,6184,48.3,170,597,28.499999999999996,1739,2423,1105,3662,1763,1422,8221,1994,True,Knocked Out
San Antonio Spurs,3178,6688,47.5,2929,5974,49.0,249,714,34.9,1597,2151,1189,3786,1896,1198,8202,1994,True,Knocked Out
New York Knicks,3098,6735,46.0,2782,5827,47.699999999999996,316,908,34.8,1564,2097,1175,3717,2067,1360,8076,1994,True,Runner-Up
Philadelphia 76ers,3103,6819,45.5,2785,5877,47.4,318,942,33.800000000000004,1509,2112,1012,3406,1827,1368,8033,1994,False,Never Qualified
Chicago Bulls,3245,6815,47.599999999999994,3012,6156,48.9,233,659,35.4,1310,1859,1143,3534,2102,1306,8033,1994,True,Knocked Out
Milwaukee Bucks,3044,6807,44.7,2713,5788,46.9,331,1019,32.5,1530,2181,1126,3280,1946,1343,7949,1994,False,Never Qualified
Detroit Pistons,3169,7017,45.2,2811,5976,47.0,358,1041,34.4,1253,1715,1027,3347,1767,1236,7949,1994,False,Never Qualified
Minnesota Timberwolves,2985,6535,45.7,2802,5978,46.9,183,557,32.9,1777,2303,990,3333,1967,1478,7930,1994,False,Never Qualified
Dallas Mavericks,3055,7070,43.2,2814,6297,44.7,241,773,31.2,1450,1942,1271,3421,1629,1393,7801,1994,False,Never Qualified
Orlando Magic,3460,6899,50.2,2937,5487,53.5,523,1412,37.0,1648,2465,1149,3606,2281,1297,9091,1995,True,Runner-Up
Phoenix Suns,3356,6967,48.199999999999996,2772,5383,51.5,584,1584,36.9,1777,2352,1027,3430,2198,1167,9073,1995,True,Knocked Out
Oklahoma City Thunder,3310,6741,49.1,2819,5436,51.9,491,1305,37.6,1944,2564,1068,3405,2115,1295,9055,1995,True,Knocked Out
San Antonio Spurs,3236,6687,48.4,2802,5529,50.7,434,1158,37.5,1836,2487,1029,3690,1919,1246,8742,1995,True,Knocked Out
Utah Jazz,3243,6339,51.2,2942,5538,53.1,301,801,37.6,1939,2483,874,3286,2256,1289,8726,1995,True,Knocked Out
Golden State Warriors,3217,6873,46.800000000000004,2671,5271,50.7,546,1602,34.1,1687,2395,1101,3472,2017,1497,8667,1995,False,Never Qualified
Los Angeles Lakers,3284,7088,46.300000000000004,2759,5596,49.3,525,1492,35.199999999999996,1523,2072,1126,3442,2078,1243,8616,1995,True,Knocked Out
Houston Rockets,3159,6579,48.0,2513,4822,52.1,646,1757,36.8,1527,2039,880,3320,2060,1322,8491,1995,True,Champion
Dallas Mavericks,3227,7342,44.0,2841,6142,46.300000000000004,386,1200,32.2,1622,2210,1514,3947,1941,1345,8462,1995,False,Never Qualified
Portland Trail Blazers,3217,7134,45.1,2755,5868,46.9,462,1266,36.5,1555,2230,1352,3795,1846,1212,8451,1995,True,Knocked Out
Boston Celtics,3179,6847,46.400000000000006,2817,5863,48.0,362,984,36.8,1708,2268,1156,3476,1783,1305,8428,1995,True,Knocked Out
Chicago Bulls,3191,6710,47.599999999999994,2748,5523,49.8,443,1187,37.3,1500,2065,1106,3400,1970,1297,8325,1995,True,Knocked Out
Denver Nuggets,3098,6461,47.9,2685,5301,50.7,413,1160,35.6,1700,2305,1040,3442,1836,1381,8309,1995,True,Knocked Out
Miami Heat,3144,6738,46.7,2708,5556,48.699999999999996,436,1182,36.9,1569,2133,1092,3364,1779,1291,8293,1995,False,Never Qualified
Charlotte Hornets,3051,6438,47.4,2491,5029,49.5,560,1409,39.7,1587,2042,832,3227,2072,1224,8249,1995,True,Knocked Out
Washington Wizards,3176,6899,46.0,2743,5635,48.699999999999996,433,1264,34.300000000000004,1457,2013,1044,3263,1749,1301,8242,1995,False,Never Qualified
Milwaukee Bucks,3022,6586,45.9,2528,5237,48.3,494,1349,36.6,1608,2259,1063,3250,1737,1393,8146,1995,False,Never Qualified
Indiana Pacers,2983,6248,47.699999999999996,2609,5263,49.6,374,985,38.0,1796,2390,1051,3341,1877,1340,8136,1995,True,Knocked Out
Sacramento Kings,3025,6463,46.800000000000004,2666,5426,49.1,359,1037,34.599999999999994,1647,2317,1073,3398,1824,1449,8056,1995,False,Never Qualified
New York Knicks,2985,6394,46.7,2453,4948,49.6,532,1446,36.8,1552,2114,929,3402,2055,1305,8054,1995,True,Knocked Out
Detroit Pistons,3060,6633,46.1,2566,5237,49.0,494,1396,35.4,1439,1941,958,3162,1872,1318,8053,1995,False,Never Qualified
Brooklyn Nets,2939,6738,43.6,2525,5441,46.400000000000006,414,1297,31.900000000000002,1750,2305,1213,3782,1884,1300,8042,1995,False,Never Qualified
Los Angeles Clippers,3060,6888,44.4,2729,5837,46.800000000000004,331,1051,31.5,1476,2079,1064,3140,1805,1334,7927,1995,False,Never Qualified
Atlanta Hawks,2986,6680,44.7,2447,5100,48.0,539,1580,34.1,1410,1948,1104,3376,1757,1221,7921,1995,True,Knocked Out
Philadelphia 76ers,2949,6577,44.800000000000004,2594,5641,46.0,355,936,37.9,1567,2125,1105,3335,1566,1355,7820,1995,False,Never Qualified
Minnesota Timberwolves,2792,6219,44.9,2474,5203,47.5,318,1016,31.3,1824,2355,883,2973,1780,1400,7726,1995,False,Never Qualified
Cleveland Cavaliers,2756,6255,44.1,2358,5222,45.2,398,1033,38.5,1507,1982,1045,3282,1672,1176,7417,1995,True,Knocked Out
Chicago Bulls,3293,6892,47.8,2749,5543,49.6,544,1349,40.300000000000004,1495,2004,1247,3658,2033,1175,8625,1996,True,Champion
Oklahoma City Thunder,3074,6401,48.0,2493,4805,51.9,581,1596,36.4,1843,2424,954,3403,1999,1441,8572,1996,True,Knocked Out
Orlando Magic,3203,6640,48.199999999999996,2581,4995,51.7,622,1645,37.8,1543,2232,966,3367,2080,1160,8571,1996,True,Knocked Out
Phoenix Suns,3159,6673,47.3,2832,5689,49.8,327,984,33.2,1907,2472,1009,3510,2001,1207,8552,1996,True,Knocked Out
Boston Celtics,3163,6942,45.6,2624,5489,47.8,539,1453,37.1,1630,2284,1050,3477,1792,1302,8495,1996,False,Never Qualified
San Antonio Spurs,3148,6602,47.699999999999996,2630,5282,49.8,518,1320,39.2,1663,2261,937,3523,2044,1195,8477,1996,True,Knocked Out
Los Angeles Lakers,3216,6706,48.0,2739,5347,51.2,477,1359,35.099999999999994,1529,2049,995,3298,2080,1163,8438,1996,True,Knocked Out
Charlotte Hornets,3108,6618,47.0,2524,5098,49.5,584,1520,38.4,1631,2119,987,3243,1907,1241,8431,1996,False,Never Qualified
Dallas Mavericks,3124,7431,42.0,2389,5392,44.3,735,2039,36.0,1426,1975,1408,3787,1913,1270,8409,1996,False,Never Qualified
Washington Wizards,3202,6618,48.4,2709,5406,50.1,493,1212,40.699999999999996,1511,2076,930,3257,1815,1327,8408,1996,False,Never Qualified
Houston Rockets,3078,6638,46.400000000000006,2441,4877,50.1,637,1761,36.199999999999996,1611,2106,919,3374,1982,1245,8404,1996,True,Knocked Out
Utah Jazz,3129,6417,48.8,2752,5404,50.9,377,1013,37.2,1769,2302,993,3366,2139,1215,8404,1996,True,Knocked Out
Golden State Warriors,3056,6700,45.6,2609,5501,47.4,447,1199,37.3,1775,2340,1173,3458,1889,1343,8334,1996,False,Never Qualified
Sacramento Kings,2971,6494,45.7,2509,5300,47.3,462,1194,38.7,1759,2407,1114,3459,1829,1442,8163,1996,True,Knocked Out
Los Angeles Clippers,3126,6618,47.199999999999996,2617,5244,49.9,509,1374,37.0,1392,1984,979,3169,1672,1355,8153,1996,False,Never Qualified
Portland Trail Blazers,3064,6688,45.800000000000004,2584,5330,48.5,480,1358,35.3,1537,2321,1160,3737,1760,1377,8145,1996,True,Knocked Out
Indiana Pacers,2979,6205,48.0,2616,5232,50.0,363,973,37.3,1823,2416,1010,3272,1917,1335,8144,1996,True,Knocked Out
Atlanta Hawks,2985,6665,44.800000000000004,2419,5070,47.699999999999996,566,1595,35.5,1523,2012,1182,3330,1609,1228,8059,1996,True,Knocked Out
Minnesota Timberwolves,2974,6481,45.9,2695,5624,47.9,279,857,32.6,1797,2314,985,3256,1867,1426,8024,1996,False,Never Qualified
Denver Nuggets,3001,6657,45.1,2604,5509,47.3,397,1148,34.599999999999994,1614,2173,1057,3544,1851,1265,8013,1996,False,Never Qualified
Toronto Raptors,3084,6598,46.7,2670,5430,49.2,414,1168,35.4,1412,1953,1071,3284,1927,1544,7994,1996,False,Never Qualified
New York Knicks,3003,6382,47.099999999999994,2518,5097,49.4,485,1285,37.7,1480,1954,829,3278,1822,1272,7971,1996,True,Knocked Out
Miami Heat,2902,6348,45.7,2350,4890,48.1,552,1458,37.9,1553,2187,999,3494,1752,1394,7909,1996,True,Knocked Out
Milwaukee Bucks,3034,6490,46.7,2677,5434,49.3,357,1056,33.800000000000004,1412,1914,973,3137,1755,1295,7837,1996,False,Never Qualified
Detroit Pistons,2810,6122,45.9,2265,4772,47.5,545,1350,40.400000000000006,1657,2206,884,3324,1610,1215,7822,1996,True,Knocked Out
Philadelphia 76ers,2796,6418,43.6,2304,4980,46.300000000000004,492,1438,34.2,1662,2263,1031,3192,1629,1414,7746,1996,False,Never Qualified
Brooklyn Nets,2881,6750,42.699999999999996,2631,6004,43.8,250,746,33.5,1672,2244,1350,3853,1752,1375,7684,1996,False,Never Qualified
Cleveland Cavaliers,2761,5998,46.0,2165,4416,49.0,596,1582,37.7,1355,1775,867,2922,1818,1073,7473,1996,True,Knocked Out
Memphis Grizzlies,2772,6483,42.8,2400,5354,44.800000000000004,372,1129,32.9,1446,1998,957,3127,1706,1347,7362,1996,False,Never Qualified
Chicago Bulls,3277,6923,47.3,2754,5520,49.9,523,1403,37.3,1381,1848,1235,3696,2142,1109,8458,1997,True,Champion
Utah Jazz,3131,6217,50.4,2797,5315,52.6,334,902,37.0,1858,2416,889,3299,2199,1259,8454,1997,True,Runner-Up
Phoenix Suns,3143,6705,46.9,2616,5277,49.6,527,1428,36.9,1618,2125,916,3292,2067,1180,8431,1997,True,Knocked Out
Oklahoma City Thunder,2995,6415,46.7,2436,4832,50.4,559,1583,35.3,1725,2295,1010,3281,1931,1231,8274,1997,True,Knocked Out
Boston Celtics,3066,6967,44.0,2599,5636,46.1,467,1331,35.099999999999994,1649,2199,1095,3283,1792,1342,8248,1997,False,Never Qualified
Houston Rockets,3037,6484,46.800000000000004,2366,4645,50.9,671,1839,36.5,1503,1992,927,3492,2013,1365,8248,1997,True,Knocked Out
Philadelphia 76ers,3003,6850,43.8,2570,5494,46.800000000000004,433,1356,31.900000000000002,1776,2450,1267,3622,1695,1437,8215,1997,False,Never Qualified
Los Angeles Lakers,3018,6642,45.4,2467,5142,48.0,551,1500,36.7,1613,2330,1092,3506,1845,1222,8200,1997,True,Knocked Out
Golden State Warriors,2997,6567,45.6,2516,5204,48.3,481,1363,35.3,1696,2180,1086,3345,1822,1410,8171,1997,False,Never Qualified
Washington Wizards,3208,6678,48.0,2877,5677,50.7,331,1001,33.1,1400,1979,1010,3430,1921,1289,8147,1997,True,Knocked Out
Portland Trail Blazers,3000,6465,46.400000000000006,2499,5064,49.3,501,1401,35.8,1613,2261,1058,3552,1710,1357,8114,1997,True,Knocked Out
Charlotte Hornets,2988,6342,47.099999999999994,2397,4960,48.3,591,1382,42.8,1541,1984,910,3208,2021,1203,8108,1997,True,Knocked Out
Denver Nuggets,2934,6687,43.9,2298,4976,46.2,636,1711,37.2,1516,1992,994,3446,1889,1359,8020,1997,False,Never Qualified
Brooklyn Nets,2994,7091,42.199999999999996,2510,5720,43.9,484,1371,35.3,1502,2031,1410,3786,1726,1290,7974,1997,False,Never Qualified
Los Angeles Clippers,2989,6696,44.6,2515,5357,46.9,474,1339,35.4,1517,2074,1092,3334,1662,1311,7969,1997,True,Knocked Out
Sacramento Kings,3000,6611,45.4,2586,5553,46.6,414,1058,39.1,1494,2067,1100,3407,1799,1332,7908,1997,False,Never Qualified
Minnesota Timberwolves,2937,6436,45.6,2566,5343,48.0,371,1093,33.900000000000006,1637,2180,957,3259,1874,1243,7882,1997,True,Knocked Out
Toronto Raptors,2897,6632,43.7,2308,5008,46.1,589,1624,36.3,1446,2008,1135,3389,1714,1347,7829,1997,False,Never Qualified
New York Knicks,2882,6227,46.300000000000004,2412,4933,48.9,470,1294,36.3,1585,2119,973,3489,1809,1462,7819,1997,True,Knocked Out
Indiana Pacers,2851,6254,45.6,2421,5124,47.199999999999996,430,1130,38.1,1687,2336,1029,3419,1750,1338,7819,1997,False,Never Qualified
Milwaukee Bucks,2967,6303,47.099999999999994,2643,5383,49.1,324,920,35.199999999999996,1560,2104,955,3218,1610,1285,7818,1997,False,Never Qualified
Miami Heat,2822,6235,45.300000000000004,2144,4370,49.1,678,1865,36.4,1454,2022,957,3359,1735,1306,7776,1997,True,Knocked Out
Atlanta Hawks,2812,6307,44.6,2153,4473,48.1,659,1834,35.9,1491,1955,1021,3371,1557,1228,7774,1997,True,Knocked Out
Detroit Pistons,2827,6095,46.400000000000006,2245,4596,48.8,582,1499,38.800000000000004,1487,1995,858,3150,1554,1041,7723,1997,True,Knocked Out
Orlando Magic,2839,6497,43.7,2272,4835,47.0,567,1662,34.1,1474,1975,1071,3292,1689,1250,7719,1997,True,Knocked Out
Dallas Mavericks,2813,6452,43.6,2383,5136,46.400000000000006,430,1316,32.7,1375,1918,1040,3302,1663,1324,7431,1997,False,Never Qualified
San Antonio Spurs,2827,6391,44.2,2449,5211,47.0,378,1180,32.0,1386,1929,1101,3230,1661,1243,7418,1997,False,Never Qualified
Memphis Grizzlies,2819,6453,43.7,2374,5179,45.800000000000004,445,1274,34.9,1230,1734,1023,3178,1862,1301,7313,1997,False,Never Qualified
Cleveland Cavaliers,2704,5972,45.300000000000004,2221,4688,47.4,483,1284,37.6,1282,1773,909,3068,1714,1188,7173,1997,False,Never Qualified
Los Angeles Lakers,3146,6536,48.1,2649,5121,51.7,497,1415,35.099999999999994,1863,2743,1079,3550,2009,1256,8652,1998,True,Knocked Out
Minnesota Timberwolves,3157,6844,46.1,2854,5971,47.8,303,873,34.699999999999996,1673,2253,1063,3492,2068,1138,8290,1998,True,Knocked Out
Utah Jazz,2993,6113,49.0,2744,5443,50.4,249,670,37.2,2044,2644,962,3367,2070,1260,8279,1998,True,Runner-Up
Oklahoma City Thunder,3052,6458,47.3,2431,4889,49.7,621,1569,39.6,1521,2109,931,3156,1986,1145,8246,1998,True,Knocked Out
Brooklyn Nets,3055,6928,44.1,2745,5991,45.800000000000004,310,937,33.1,1750,2351,1344,3481,1685,1180,8170,1998,True,Knocked Out
Phoenix Suns,3138,6710,46.800000000000004,2707,5499,49.2,431,1211,35.6,1459,1948,991,3443,2124,1236,8166,1998,True,Knocked Out
Houston Rockets,2946,6513,45.2,2373,4843,49.0,573,1670,34.300000000000004,1634,2120,987,3337,1799,1298,8099,1998,True,Knocked Out
Washington Wizards,3080,6811,45.2,2760,5867,47.0,320,944,33.900000000000006,1489,2156,1121,3462,1900,1156,7969,1998,False,Never Qualified
Chicago Bulls,3064,6801,45.1,2753,5839,47.099999999999994,311,962,32.300000000000004,1492,2009,1243,3681,1952,1178,7931,1998,True,Champion
Charlotte Hornets,2968,6344,46.800000000000004,2622,5440,48.199999999999996,346,904,38.3,1641,2186,985,3326,1941,1247,7923,1998,True,Knocked Out
Memphis Grizzlies,3006,6567,45.800000000000004,2681,5669,47.3,325,898,36.199999999999996,1586,2145,1081,3394,1960,1405,7923,1998,False,Never Qualified
Indiana Pacers,2921,6223,46.9,2520,5194,48.5,401,1029,39.0,1631,2136,874,3222,1889,1168,7874,1998,True,Knocked Out
Los Angeles Clippers,2930,6690,43.8,2405,5222,46.1,525,1468,35.8,1480,2047,1040,3316,1533,1323,7865,1998,False,Never Qualified
Boston Celtics,3012,6934,43.4,2597,5685,45.7,415,1249,33.2,1425,1964,1196,3240,1816,1330,7864,1998,False,Never Qualified
Atlanta Hawks,2887,6352,45.5,2550,5336,47.8,337,1016,33.2,1749,2314,1106,3523,1569,1214,7860,1998,True,Knocked Out
Miami Heat,2850,6327,45.0,2302,4783,48.1,548,1544,35.5,1539,2082,1028,3447,1758,1226,7787,1998,True,Knocked Out
Toronto Raptors,2965,6813,43.5,2593,5727,45.300000000000004,372,1086,34.300000000000004,1479,2060,1187,3336,1746,1371,7781,1998,False,Never Qualified
Milwaukee Bucks,2918,6399,45.6,2669,5696,46.9,249,703,35.4,1663,2167,1035,3271,1649,1383,7748,1998,False,Never Qualified
Portland Trail Blazers,2885,6397,45.1,2561,5350,47.9,324,1047,30.9,1640,2226,1086,3608,1766,1383,7734,1998,True,Knocked Out
Detroit Pistons,2862,6373,44.9,2569,5435,47.3,293,938,31.2,1704,2288,1044,3382,1597,1198,7721,1998,False,Never Qualified
Philadelphia 76ers,2837,6409,44.3,2594,5599,46.300000000000004,243,810,30.0,1734,2352,1125,3419,1729,1354,7651,1998,False,Never Qualified
Sacramento Kings,2957,6684,44.2,2674,5878,45.5,283,806,35.099999999999994,1440,2096,1094,3398,1836,1271,7637,1998,False,Never Qualified
San Antonio Spurs,2898,6187,46.800000000000004,2596,5324,48.8,302,863,35.0,1489,2164,984,3622,1839,1318,7587,1998,True,Knocked Out
Cleveland Cavaliers,2817,6207,45.4,2519,5406,46.6,298,801,37.2,1653,2187,955,3286,1894,1418,7585,1998,True,Knocked Out
New York Knicks,2864,6413,44.7,2482,5274,47.099999999999994,382,1139,33.5,1399,1812,978,3412,1787,1247,7509,1998,True,Knocked Out
Dallas Mavericks,2882,6754,42.699999999999996,2460,5571,44.2,422,1183,35.699999999999996,1308,1738,1008,3288,1535,1182,7494,1998,False,Never Qualified
Orlando Magic,2771,6455,42.9,2478,5548,44.7,293,907,32.300000000000004,1552,2138,1178,3381,1694,1258,7387,1998,False,Never Qualified
Denver Nuggets,2677,6412,41.699999999999996,2389,5519,43.3,288,893,32.300000000000004,1658,2147,1040,3197,1547,1311,7300,1998,False,Never Qualified
Golden State Warriors,2845,6883,41.3,2656,6187,42.9,189,696,27.200000000000003,1358,1912,1288,3761,1708,1369,7237,1998,False,Never Qualified
Sacramento Kings,1918,4307,44.5,1628,3364,48.4,290,943,30.8,883,1293,706,2279,1129,842,5009,1999,True,Knocked Out
Los Angeles Lakers,1841,3935,46.800000000000004,1600,3250,49.2,241,685,35.199999999999996,1027,1503,619,2101,1095,754,4950,1999,True,Knocked Out
Phoenix Suns,1797,4004,44.9,1536,3302,46.5,261,702,37.2,924,1215,598,2016,1249,681,4779,1999,True,Knocked Out
Oklahoma City Thunder,1756,3976,44.2,1447,3077,47.0,309,899,34.4,922,1354,676,2098,1087,765,4743,1999,False,Never Qualified
Portland Trail Blazers,1747,3956,44.2,1501,3281,45.7,246,675,36.4,1002,1349,646,2216,1073,771,4742,1999,True,Knocked Out
Indiana Pacers,1731,3866,44.800000000000004,1437,3067,46.9,294,799,36.8,977,1228,574,2026,1005,649,4733,1999,True,Knocked Out
Houston Rockets,1755,3798,46.2,1419,2884,49.2,336,914,36.8,865,1187,536,2076,1058,812,4711,1999,True,Knocked Out
Denver Nuggets,1681,3989,42.1,1379,3067,45.0,302,922,32.800000000000004,1010,1325,647,2039,969,739,4674,1999,False,Never Qualified
Utah Jazz,1684,3620,46.5,1544,3232,47.8,140,388,36.1,1158,1510,555,2063,1204,814,4666,1999,True,Knocked Out
Boston Celtics,1816,4164,43.6,1543,3406,45.300000000000004,273,758,36.0,745,1077,680,2138,1073,807,4650,1999,False,Never Qualified
Minnesota Timberwolves,1838,4327,42.5,1716,3917,43.8,122,410,29.799999999999997,849,1143,754,2146,1218,641,4647,1999,True,Knocked Out
Charlotte Hornets,1671,3718,44.9,1403,2983,47.0,268,735,36.5,1034,1384,480,1973,1110,796,4644,1999,False,Never Qualified
San Antonio Spurs,1740,3812,45.6,1568,3291,47.599999999999994,172,521,33.0,988,1415,614,2198,1101,759,4640,1999,True,Champion
Milwaukee Bucks,1753,3818,45.9,1522,3199,47.599999999999994,231,619,37.3,847,1155,570,1939,1030,719,4584,1999,True,Knocked Out
Dallas Mavericks,1749,4033,43.4,1547,3438,45.0,202,595,33.900000000000006,881,1210,645,2123,921,692,4581,1999,False,Never Qualified
Brooklyn Nets,1691,4160,40.6,1466,3481,42.1,225,679,33.1,962,1251,715,2152,923,750,4569,1999,False,Never Qualified
Washington Wizards,1768,3969,44.5,1589,3389,46.9,179,580,30.9,845,1198,595,1998,1064,736,4560,1999,False,Never Qualified
Toronto Raptors,1660,3940,42.1,1434,3278,43.7,226,662,34.1,1011,1330,712,2159,1036,799,4557,1999,False,Never Qualified
Los Angeles Clippers,1711,4007,42.699999999999996,1497,3339,44.800000000000004,214,668,32.0,883,1225,665,1958,820,796,4519,1999,False,Never Qualified
Detroit Pistons,1660,3716,44.7,1412,3037,46.5,248,679,36.5,950,1283,605,2017,1009,790,4518,1999,True,Knocked Out
Philadelphia 76ers,1656,3883,42.6,1558,3512,44.4,98,371,26.400000000000002,1073,1486,729,2157,934,822,4483,1999,True,Knocked Out
Orlando Magic,1687,3943,42.8,1464,3268,44.800000000000004,223,675,33.0,876,1252,688,2133,1067,819,4473,1999,True,Knocked Out
Miami Heat,1616,3565,45.300000000000004,1327,2761,48.1,289,804,35.9,928,1262,503,2015,1019,744,4449,1999,True,Knocked Out
Memphis Grizzlies,1643,3838,42.8,1495,3385,44.2,148,453,32.7,1009,1408,650,2009,964,848,4443,1999,False,Never Qualified
Golden State Warriors,1730,4173,41.5,1568,3608,43.5,162,565,28.7,794,1175,816,2375,1037,768,4416,1999,False,Never Qualified
Cleveland Cavaliers,1562,3561,43.9,1380,3027,45.6,182,534,34.1,1016,1356,472,1788,1093,785,4322,1999,False,Never Qualified
New York Knicks,1610,3704,43.5,1402,3115,45.0,208,589,35.3,892,1218,551,2061,963,804,4320,1999,True,Runner-Up
Atlanta Hawks,1539,3760,40.9,1342,3116,43.1,197,644,30.599999999999998,1040,1422,676,2175,782,745,4315,1999,True,Knocked Out
Chicago Bulls,1539,3837,40.1,1362,3225,42.199999999999996,177,612,28.9,840,1185,573,1967,1017,774,4095,1999,False,Never Qualified
Sacramento Kings,3276,7288,45.0,2742,5632,48.699999999999996,534,1656,32.2,1521,2016,1056,3691,1953,1325,8607,2000,True,Knocked Out
Detroit Pistons,3044,6635,45.9,2605,5412,48.1,439,1223,35.9,1956,2506,917,3375,1707,1288,8483,2000,True,Knocked Out
Dallas Mavericks,3195,7047,45.300000000000004,2676,5721,46.800000000000004,519,1326,39.1,1407,1751,931,3375,1810,1124,8316,2000,False,Never Qualified
Indiana Pacers,3047,6640,45.9,2464,5153,47.8,583,1487,39.2,1629,2008,842,3454,1857,1159,8306,2000,True,Runner-Up
Milwaukee Bucks,3174,6827,46.5,2780,5758,48.3,394,1069,36.9,1558,1982,1016,3389,1852,1230,8300,2000,True,Knocked Out
Los Angeles Lakers,3137,6836,45.9,2793,5789,48.199999999999996,344,1047,32.9,1649,2368,1117,3855,1921,1143,8267,2000,True,Champion
Orlando Magic,3169,7014,45.2,2875,6144,46.800000000000004,294,870,33.800000000000004,1574,2142,1145,3685,1709,1443,8206,2000,False,Never Qualified
Houston Rockets,3001,6664,45.0,2420,5039,48.0,581,1625,35.8,1573,2145,1008,3594,1774,1425,8156,2000,False,Never Qualified
Boston Celtics,3054,6880,44.4,2637,5620,46.9,417,1260,33.1,1621,2175,1108,3528,1741,1259,8146,2000,False,Never Qualified
Oklahoma City Thunder,3108,6946,44.7,2562,5335,48.0,546,1611,33.900000000000006,1363,1960,1042,3525,1878,1152,8125,2000,True,Knocked Out
Denver Nuggets,3057,6911,44.2,2587,5514,46.9,470,1397,33.6,1531,2116,1073,3663,1911,1281,8115,2000,False,Never Qualified
Phoenix Suns,3093,6771,45.7,2635,5525,47.699999999999996,458,1246,36.8,1467,1934,1022,3580,2098,1368,8111,2000,True,Knocked Out
Minnesota Timberwolves,3226,6910,46.7,2978,6194,48.1,248,716,34.599999999999994,1379,1769,1016,3487,2205,1139,8079,2000,True,Knocked Out
Charlotte Hornets,2935,6533,44.9,2596,5532,46.9,339,1001,33.900000000000006,1863,2458,884,3519,2023,1206,8072,2000,True,Knocked Out
Brooklyn Nets,2979,6881,43.3,2502,5507,45.4,477,1374,34.699999999999996,1601,2041,1040,3355,1688,1119,8036,2000,False,Never Qualified
Portland Trail Blazers,3021,6430,47.0,2614,5302,49.3,407,1128,36.1,1542,2029,966,3526,1925,1243,7991,2000,True,Knocked Out
Toronto Raptors,2980,6882,43.3,2555,5711,44.7,425,1171,36.3,1583,2068,1098,3547,1947,1137,7968,2000,True,Knocked Out
Cleveland Cavaliers,2977,6734,44.2,2634,5815,45.300000000000004,343,919,37.3,1653,2205,1010,3509,1941,1427,7950,2000,False,Never Qualified
Washington Wizards,3010,6681,45.1,2675,5791,46.2,335,890,37.6,1566,2107,1064,3502,1771,1320,7921,2000,False,Never Qualified
Utah Jazz,2962,6380,46.400000000000006,2633,5526,47.599999999999994,329,854,38.5,1661,2150,936,3362,2041,1220,7914,2000,True,Knocked Out
San Antonio Spurs,2952,6393,46.2,2622,5511,47.599999999999994,330,882,37.4,1652,2214,927,3593,1819,1233,7886,2000,True,Knocked Out
Golden State Warriors,2996,7140,42.0,2651,6071,43.7,345,1069,32.300000000000004,1497,2147,1300,3738,1851,1302,7834,2000,False,Never Qualified
Philadelphia 76ers,2993,6776,44.2,2785,6133,45.4,208,643,32.300000000000004,1577,2226,1147,3615,1817,1284,7771,2000,True,Knocked Out
Miami Heat,2974,6462,46.0,2528,5260,48.1,446,1202,37.1,1345,1827,921,3540,1931,1231,7739,2000,True,Knocked Out
Atlanta Hawks,3000,6807,44.1,2742,5993,45.800000000000004,258,814,31.7,1477,1987,1146,3716,1548,1266,7735,2000,False,Never Qualified
Memphis Grizzlies,2892,6441,44.9,2568,5543,46.300000000000004,324,898,36.1,1594,2060,1005,3329,1700,1381,7702,2000,False,Never Qualified
New York Knicks,2897,6374,45.5,2546,5437,46.800000000000004,351,937,37.5,1410,1805,802,3323,1588,1201,7555,2000,True,Knocked Out
Los Angeles Clippers,2877,6757,42.6,2448,5490,44.6,429,1267,33.900000000000006,1363,1826,955,3332,1479,1325,7546,2000,False,Never Qualified
Chicago Bulls,2565,6180,41.5,2225,5148,43.2,340,1032,32.9,1482,2089,1032,3355,1645,1557,6952,2000,False,Never Qualified
Sacramento Kings,3132,6969,44.9,2653,5616,47.199999999999996,479,1353,35.4,1600,2075,987,3692,1852,1221,8343,2001,True,Knocked Out
Milwaukee Bucks,3112,6798,45.800000000000004,2550,5317,48.0,562,1481,37.9,1474,1874,975,3475,1844,1123,8260,2001,True,Knocked Out
Los Angeles Lakers,3109,6685,46.5,2670,5410,49.4,439,1275,34.4,1594,2333,1085,3668,1888,1184,8251,2001,True,Champion
Dallas Mavericks,3085,6716,45.9,2568,5359,47.9,517,1357,38.1,1552,1954,831,3402,1740,1141,8239,2001,True,Knocked Out
Toronto Raptors,3048,6972,43.7,2619,5808,45.1,429,1164,36.9,1482,1984,1118,3647,2004,1080,8007,2001,True,Knocked Out
Orlando Magic,3013,6873,43.8,2523,5527,45.6,490,1346,36.4,1476,2068,1069,3519,1803,1245,7992,2001,True,Knocked Out
Minnesota Timberwolves,3148,6871,45.800000000000004,2826,5970,47.3,322,901,35.699999999999996,1364,1737,1002,3472,2083,1136,7982,2001,True,Knocked Out
Oklahoma City Thunder,3029,6649,45.6,2563,5480,46.800000000000004,466,1169,39.900000000000006,1454,1986,999,3421,1792,1252,7978,2001,False,Never Qualified
Houston Rockets,2943,6494,45.300000000000004,2439,5082,48.0,504,1412,35.699999999999996,1582,2086,919,3443,1613,1204,7972,2001,False,Never Qualified
Utah Jazz,2960,6289,47.099999999999994,2635,5437,48.5,325,852,38.1,1714,2280,943,3326,2110,1296,7959,2001,True,Knocked Out
Denver Nuggets,2979,6877,43.3,2467,5433,45.4,512,1444,35.5,1448,1964,1044,3627,1970,1136,7918,2001,False,Never Qualified
San Antonio Spurs,2884,6262,46.1,2439,5168,47.199999999999996,445,1094,40.699999999999996,1673,2340,902,3614,1778,1145,7886,2001,True,Knocked Out
Detroit Pistons,2919,6880,42.4,2530,5768,43.9,389,1112,35.0,1610,2233,1108,3734,1629,1304,7837,2001,False,Never Qualified
Portland Trail Blazers,3004,6417,46.800000000000004,2635,5360,49.2,369,1057,34.9,1447,1899,960,3441,1963,1257,7824,2001,True,Knocked Out
Philadelphia 76ers,2902,6487,44.7,2640,5684,46.400000000000006,262,803,32.6,1697,2277,1075,3675,1692,1292,7763,2001,True,Runner-Up
Boston Celtics,2773,6485,42.8,2181,4852,45.0,592,1633,36.3,1621,2190,897,3264,1708,1285,7759,2001,False,Never Qualified
Phoenix Suns,2944,6757,43.6,2612,5703,45.800000000000004,332,1054,31.5,1490,1973,970,3499,1905,1250,7710,2001,True,Knocked Out
Washington Wizards,2833,6453,43.9,2558,5605,45.6,275,848,32.4,1704,2245,1016,3386,1647,1391,7645,2001,False,Never Qualified
Indiana Pacers,2828,6431,44.0,2432,5272,46.1,396,1159,34.2,1539,2009,921,3516,1763,1244,7591,2001,True,Knocked Out
Golden State Warriors,2937,7175,40.9,2655,6211,42.699999999999996,282,964,29.299999999999997,1428,2024,1345,3730,1788,1301,7584,2001,False,Never Qualified
Los Angeles Clippers,2896,6467,44.800000000000004,2536,5404,46.9,360,1063,33.900000000000006,1429,2061,962,3521,1585,1293,7581,2001,False,Never Qualified
Cleveland Cavaliers,2890,6532,44.2,2670,5873,45.5,220,659,33.4,1561,2040,1015,3455,1708,1350,7561,2001,False,Never Qualified
Brooklyn Nets,2781,6550,42.5,2420,5466,44.3,361,1084,33.300000000000004,1629,2146,909,3246,1603,1208,7552,2001,False,Never Qualified
Charlotte Hornets,2800,6501,43.1,2460,5517,44.6,340,984,34.599999999999994,1599,2146,1033,3641,1900,1183,7539,2001,True,Knocked Out
Memphis Grizzlies,2870,6539,43.9,2545,5592,45.5,325,947,34.300000000000004,1457,1892,894,3325,1899,1291,7522,2001,False,Never Qualified
Atlanta Hawks,2876,6668,43.1,2543,5735,44.3,333,933,35.699999999999996,1374,1811,1028,3518,1559,1368,7459,2001,False,Never Qualified
Miami Heat,2694,6258,43.0,2216,4874,45.5,478,1384,34.5,1423,1874,813,3248,1630,1122,7289,2001,True,Knocked Out
New York Knicks,2755,6198,44.4,2364,5083,46.5,391,1115,35.099999999999994,1374,1727,773,3297,1520,1189,7275,2001,True,Knocked Out
Chicago Bulls,2721,6411,42.4,2392,5461,43.8,329,950,34.599999999999994,1410,1909,926,3186,1810,1292,7181,2001,False,Never Qualified
Dallas Mavericks,3200,6930,46.2,2579,5285,48.8,621,1645,37.8,1608,1994,918,3486,1811,992,8629,2002,True,Knocked Out
Sacramento Kings,3267,7003,46.7,2841,5843,48.6,426,1160,36.7,1618,2154,1013,3715,1958,1128,8578,2002,True,Knocked Out
Los Angeles Lakers,3150,6840,46.1,2640,5401,48.9,510,1439,35.4,1494,2138,1022,3629,1882,1040,8304,2002,True,Champion
Orlando Magic,3087,6893,44.800000000000004,2467,5233,47.099999999999994,620,1660,37.3,1446,1917,942,3382,1804,1119,8240,2002,True,Knocked Out
Minnesota Timberwolves,3175,6887,46.1,2779,5840,47.599999999999994,396,1047,37.8,1399,1754,1059,3621,1993,1097,8145,2002,True,Knocked Out
Oklahoma City Thunder,3131,6681,46.9,2642,5389,49.0,489,1292,37.8,1263,1672,968,3301,1926,1124,8014,2002,True,Knocked Out
Golden State Warriors,2998,6989,42.9,2678,5995,44.7,320,994,32.2,1693,2344,1334,3827,1706,1378,8009,2002,False,Never Qualified
Milwaukee Bucks,3041,6577,46.2,2448,4994,49.0,593,1583,37.5,1321,1767,841,3398,1847,1157,7996,2002,False,Never Qualified
Indiana Pacers,2935,6580,44.6,2530,5385,47.0,405,1195,33.900000000000006,1663,2155,930,3498,1884,1249,7938,2002,True,Knocked Out
San Antonio Spurs,2913,6363,45.800000000000004,2475,5152,48.0,438,1211,36.199999999999996,1668,2249,907,3473,1643,1180,7932,2002,True,Knocked Out
Portland Trail Blazers,3004,6671,45.0,2538,5353,47.4,466,1318,35.4,1451,1901,1085,3529,1926,1172,7925,2002,True,Knocked Out
Boston Celtics,2852,6731,42.4,2153,4785,45.0,699,1946,35.9,1498,1960,891,3461,1722,1114,7901,2002,True,Knocked Out
Brooklyn Nets,3042,6816,44.6,2639,5622,46.9,403,1194,33.800000000000004,1402,1907,1039,3554,1990,1189,7889,2002,True,Knocked Out
Utah Jazz,2869,6374,45.0,2589,5532,46.800000000000004,280,842,33.300000000000004,1853,2430,1109,3458,1999,1353,7871,2002,True,Knocked Out
Los Angeles Clippers,2970,6668,44.5,2562,5521,46.400000000000006,408,1147,35.6,1498,2026,1083,3557,1714,1214,7846,2002,False,Never Qualified
Cleveland Cavaliers,2948,6582,44.800000000000004,2561,5556,46.1,387,1026,37.7,1529,1980,968,3451,1891,1196,7812,2002,False,Never Qualified
Phoenix Suns,3097,6934,44.7,2739,5838,46.9,358,1096,32.7,1250,1630,1072,3502,1838,1205,7802,2002,False,Never Qualified
Detroit Pistons,2845,6300,45.2,2278,4791,47.5,567,1509,37.6,1478,1954,810,3176,1765,1193,7735,2002,True,Knocked Out
Atlanta Hawks,2901,6610,43.9,2478,5416,45.800000000000004,423,1194,35.4,1486,1942,955,3400,1656,1275,7711,2002,False,Never Qualified
Charlotte Hornets,2893,6580,44.0,2547,5586,45.6,346,994,34.8,1568,2105,1059,3564,1759,1150,7700,2002,True,Knocked Out
Washington Wizards,2938,6664,44.1,2633,5878,44.800000000000004,305,786,38.800000000000004,1428,1866,1055,3448,1715,1068,7609,2002,False,Never Qualified
Houston Rockets,2837,6629,42.8,2341,5149,45.5,496,1480,33.5,1402,1893,1025,3436,1482,1156,7572,2002,False,Never Qualified
Denver Nuggets,2915,6870,42.4,2492,5585,44.6,423,1285,32.9,1306,1756,1117,3427,1817,1205,7559,2002,False,Never Qualified
New York Knicks,2817,6520,43.2,2343,5176,45.300000000000004,474,1344,35.3,1406,1786,876,3334,1720,1192,7514,2002,False,Never Qualified
Toronto Raptors,2919,6727,43.4,2532,5618,45.1,387,1109,34.9,1269,1717,1114,3450,1779,1174,7494,2002,True,Knocked Out
Philadelphia 76ers,2804,6436,43.6,2590,5721,45.300000000000004,214,715,29.9,1639,2104,1092,3626,1638,1256,7461,2002,True,Knocked Out
Memphis Grizzlies,2851,6535,43.6,2515,5439,46.2,336,1096,30.7,1334,1883,984,3397,1785,1344,7372,2002,False,Never Qualified
Chicago Bulls,2811,6491,43.3,2511,5623,44.7,300,868,34.599999999999994,1413,1958,924,3283,1817,1252,7335,2002,False,Never Qualified
Miami Heat,2801,6382,43.9,2489,5483,45.4,312,899,34.699999999999996,1236,1708,902,3446,1664,1217,7150,2002,False,Never Qualified
Dallas Mavericks,3161,6982,45.300000000000004,2525,5314,47.5,636,1668,38.1,1486,1793,912,3456,1837,949,8444,2003,True,Knocked Out
Golden State Warriors,3061,6941,44.1,2636,5706,46.2,425,1235,34.4,1853,2382,1284,3830,1712,1295,8400,2003,False,Never Qualified
Sacramento Kings,3242,6990,46.400000000000006,2751,5702,48.199999999999996,491,1288,38.1,1367,1832,900,3651,2034,1192,8342,2003,True,Knocked Out
Los Angeles Lakers,3091,6856,45.1,2605,5489,47.5,486,1367,35.6,1562,2129,1078,3632,1909,1192,8230,2003,True,Knocked Out
Milwaukee Bucks,3045,6670,45.7,2460,5144,47.8,585,1526,38.3,1483,1911,876,3243,1823,1044,8158,2003,True,Knocked Out
Orlando Magic,2947,6763,43.6,2379,5173,46.0,568,1590,35.699999999999996,1616,2079,958,3350,1676,1177,8078,2003,True,Knocked Out
Minnesota Timberwolves,3172,6809,46.6,2876,6005,47.9,296,804,36.8,1406,1826,959,3573,2070,1124,8046,2003,True,Knocked Out
Memphis Grizzlies,3049,6743,45.2,2582,5464,47.3,467,1279,36.5,1430,1936,943,3409,1892,1262,7995,2003,False,Never Qualified
Philadelphia 76ers,2975,6640,44.800000000000004,2730,5853,46.6,245,787,31.1,1746,2253,1042,3457,1771,1212,7941,2003,True,Knocked Out
Indiana Pacers,2911,6608,44.1,2532,5489,46.1,379,1119,33.900000000000006,1739,2271,1004,3626,1910,1210,7940,2003,True,Knocked Out
New York Knicks,2967,6725,44.1,2361,5143,45.9,606,1582,38.3,1320,1620,842,3218,1800,1149,7860,2003,False,Never Qualified
San Antonio Spurs,2908,6297,46.2,2459,5027,48.9,449,1270,35.4,1591,2194,939,3495,1636,1295,7856,2003,True,Champion
Phoenix Suns,3005,6776,44.3,2611,5627,46.400000000000006,394,1149,34.300000000000004,1430,1928,1049,3489,1719,1208,7834,2003,True,Knocked Out
Brooklyn Nets,2906,6585,44.1,2560,5544,46.2,346,1041,33.2,1662,2195,991,3519,1887,1212,7820,2003,True,Knocked Out
Portland Trail Blazers,2987,6491,46.0,2608,5341,48.8,379,1150,33.0,1450,1947,992,3370,1860,1248,7803,2003,True,Knocked Out
Chicago Bulls,2991,6714,44.5,2642,5717,46.2,349,997,35.0,1455,2014,985,3526,1782,1388,7786,2003,False,Never Qualified
Utah Jazz,2894,6189,46.800000000000004,2670,5548,48.1,224,641,34.9,1750,2349,1021,3402,2103,1374,7762,2003,True,Knocked Out
Atlanta Hawks,2859,6434,44.4,2457,5293,46.400000000000006,402,1141,35.199999999999996,1594,2011,937,3495,1679,1367,7714,2003,False,Never Qualified
New Orleans Pelicans,2914,6695,43.5,2510,5620,44.7,404,1075,37.6,1467,1910,1097,3572,1807,1212,7699,2003,True,Knocked Out
Los Angeles Clippers,2835,6490,43.7,2445,5312,46.0,390,1178,33.1,1633,2177,1008,3470,1605,1291,7693,2003,False,Never Qualified
Houston Rockets,2840,6461,44.0,2401,5194,46.2,439,1267,34.599999999999994,1569,2044,1024,3588,1506,1276,7688,2003,False,Never Qualified
Boston Celtics,2700,6509,41.5,1981,4354,45.5,719,2155,33.4,1480,1994,849,3320,1575,1147,7599,2003,True,Knocked Out
Oklahoma City Thunder,2887,6599,43.7,2431,5308,45.800000000000004,456,1291,35.3,1325,1780,963,3348,1775,1085,7555,2003,False,Never Qualified
Washington Wizards,2816,6394,44.0,2563,5583,45.9,253,811,31.2,1617,2077,917,3312,1612,1095,7502,2003,False,Never Qualified
Cleveland Cavaliers,2850,6746,42.199999999999996,2557,5850,43.7,293,896,32.7,1502,2012,1118,3660,1712,1501,7495,2003,False,Never Qualified
Detroit Pistons,2700,6277,43.0,2167,4789,45.2,533,1488,35.8,1559,2021,883,3328,1620,1104,7492,2003,True,Knocked Out
Toronto Raptors,2847,6664,42.699999999999996,2438,5471,44.6,409,1193,34.300000000000004,1350,1879,1023,3378,1583,1181,7453,2003,False,Never Qualified
Miami Heat,2688,6517,41.199999999999996,2340,5417,43.2,348,1100,31.6,1292,1689,948,3412,1501,1167,7016,2003,False,Never Qualified
Denver Nuggets,2689,6544,41.099999999999994,2460,5720,43.0,229,824,27.800000000000004,1294,1850,1112,3475,1737,1514,6901,2003,False,Never Qualified
Dallas Mavericks,3322,7230,45.9,2815,5774,48.8,507,1456,34.8,1475,1854,1174,3712,1963,1000,8626,2004,True,Knocked Out
Sacramento Kings,3103,6711,46.2,2502,5213,48.0,601,1498,40.1,1626,2044,888,3380,2152,1137,8433,2004,True,Knocked Out
Los Angeles Lakers,3028,6676,45.4,2663,5561,47.9,365,1115,32.7,1631,2352,1001,3536,1948,1132,8052,2004,True,Runner-Up
Milwaukee Bucks,2970,6650,44.7,2569,5505,46.7,401,1145,35.0,1698,2192,960,3462,1872,1110,8039,2004,True,Knocked Out
Denver Nuggets,2993,6763,44.3,2662,5778,46.1,331,985,33.6,1655,2159,1083,3470,1794,1278,7972,2004,True,Knocked Out
Oklahoma City Thunder,2939,6590,44.6,2216,4654,47.599999999999994,723,1936,37.3,1363,1782,907,3225,1782,1188,7964,2004,False,Never Qualified
Memphis Grizzlies,2963,6657,44.5,2516,5343,47.099999999999994,447,1314,34.0,1557,2143,1047,3428,1915,1226,7930,2004,True,Knocked Out
Boston Celtics,2843,6415,44.3,2290,4816,47.5,553,1599,34.599999999999994,1572,2095,851,3291,1683,1332,7811,2004,True,Knocked Out
Los Angeles Clippers,2817,6579,42.8,2488,5555,44.800000000000004,329,1024,32.1,1808,2302,1149,3565,1653,1344,7771,2004,False,Never Qualified
Minnesota Timberwolves,3033,6571,46.2,2707,5674,47.699999999999996,326,897,36.3,1361,1743,875,3520,1890,1043,7753,2004,True,Knocked Out
Phoenix Suns,2958,6671,44.3,2543,5469,46.5,415,1202,34.5,1392,1865,924,3330,1586,1249,7723,2004,False,Never Qualified
Orlando Magic,2904,6768,42.9,2475,5520,44.800000000000004,429,1248,34.4,1474,2000,1003,3353,1584,1123,7711,2004,False,Never Qualified
Golden State Warriors,2875,6511,44.2,2446,5228,46.800000000000004,429,1283,33.4,1470,2028,1002,3535,1681,1211,7649,2004,False,Never Qualified
Cleveland Cavaliers,2922,6753,43.3,2675,5967,44.800000000000004,247,786,31.4,1528,2030,1118,3737,1808,1216,7619,2004,False,Never Qualified
Atlanta Hawks,2829,6529,43.3,2410,5280,45.6,419,1249,33.5,1534,1976,996,3503,1648,1350,7611,2004,False,Never Qualified
New York Knicks,2881,6513,44.2,2475,5398,45.9,406,1115,36.4,1374,1732,950,3493,1695,1289,7542,2004,True,Knocked Out
New Orleans Pelicans,2772,6605,42.0,2241,4939,45.4,531,1666,31.900000000000002,1454,1937,1091,3509,1716,1228,7529,2004,True,Knocked Out
Washington Wizards,2758,6556,42.1,2325,5287,44.0,433,1269,34.1,1579,2211,1115,3507,1537,1439,7528,2004,False,Never Qualified
San Antonio Spurs,2842,6434,44.2,2434,5294,46.0,408,1140,35.8,1409,2069,1029,3698,1676,1203,7501,2004,True,Knocked Out
Indiana Pacers,2753,6322,43.5,2304,5041,45.7,449,1281,35.099999999999994,1538,2014,965,3417,1774,1182,7493,2004,True,Knocked Out
Portland Trail Blazers,2898,6467,44.800000000000004,2517,5365,46.9,381,1102,34.599999999999994,1263,1728,1040,3416,1768,1213,7440,2004,False,Never Qualified
Miami Heat,2729,6417,42.5,2244,5060,44.3,485,1357,35.699999999999996,1459,1915,940,3399,1565,1137,7402,2004,True,Knocked Out
Brooklyn Nets,2813,6372,44.1,2436,5249,46.400000000000006,377,1123,33.6,1398,1856,862,3335,2009,1209,7401,2004,True,Knocked Out
Detroit Pistons,2747,6314,43.5,2414,5346,45.2,333,968,34.4,1561,2074,1014,3506,1702,1241,7388,2004,True,Champion
Houston Rockets,2738,6195,44.2,2223,4789,46.400000000000006,515,1406,36.6,1371,1774,847,3494,1579,1373,7362,2004,True,Knocked Out
Chicago Bulls,2798,6753,41.4,2369,5497,43.1,429,1256,34.2,1330,1834,1048,3567,1793,1321,7355,2004,False,Never Qualified
Utah Jazz,2690,6172,43.6,2438,5386,45.300000000000004,252,786,32.1,1639,2196,1103,3375,1671,1365,7271,2004,False,Never Qualified
Philadelphia 76ers,2682,6260,42.8,2343,5268,44.5,339,992,34.2,1512,2009,941,3349,1640,1307,7215,2004,False,Never Qualified
Toronto Raptors,2654,6348,41.8,2193,5054,43.4,461,1294,35.6,1237,1650,830,3249,1574,1164,7006,2004,False,Never Qualified
Phoenix Suns,3351,7018,47.699999999999996,2555,4992,51.2,796,2026,39.300000000000004,1556,2080,967,3619,1927,1125,9054,2005,True,Knocked Out
Sacramento Kings,3203,6978,45.9,2681,5582,48.0,522,1396,37.4,1577,2004,1023,3478,2005,1073,8505,2005,True,Knocked Out
Dallas Mavericks,3058,6691,45.7,2595,5418,47.9,463,1273,36.4,1826,2314,990,3520,1610,1102,8405,2005,True,Knocked Out
Miami Heat,3097,6368,48.6,2622,5108,51.300000000000004,475,1260,37.7,1658,2466,887,3526,1790,1127,8327,2005,True,Knocked Out
Boston Celtics,3046,6511,46.800000000000004,2609,5259,49.6,437,1252,34.9,1775,2323,909,3347,1810,1297,8304,2005,True,Knocked Out
Washington Wizards,2966,6794,43.7,2452,5296,46.300000000000004,514,1498,34.300000000000004,1795,2476,1133,3507,1563,1172,8241,2005,True,Knocked Out
Toronto Raptors,2952,6656,44.4,2304,4975,46.300000000000004,648,1681,38.5,1626,2101,844,3288,1670,1087,8178,2005,False,Never Qualified
Denver Nuggets,3038,6615,45.9,2718,5675,47.9,320,940,34.0,1765,2313,967,3440,1958,1224,8161,2005,True,Knocked Out
Orlando Magic,3034,6679,45.4,2714,5763,47.099999999999994,320,916,34.9,1772,2335,1038,3582,1583,1322,8160,2005,False,Never Qualified
Philadelphia 76ers,2946,6736,43.7,2441,5283,46.2,505,1453,34.8,1731,2194,909,3445,1710,1274,8128,2005,True,Knocked Out
Oklahoma City Thunder,2882,6498,44.4,2216,4674,47.4,666,1824,36.5,1683,2131,1041,3352,1487,1113,8113,2005,True,Knocked Out
Los Angeles Lakers,2895,6629,43.7,2251,4816,46.7,644,1813,35.5,1661,2137,1028,3539,1672,1176,8095,2005,False,Never Qualified
Golden State Warriors,3029,7039,43.0,2405,5265,45.7,624,1774,35.199999999999996,1412,1955,1069,3505,1811,1112,8094,2005,False,Never Qualified
New York Knicks,2978,6599,45.1,2537,5359,47.3,441,1240,35.6,1580,2060,965,3358,1665,1204,7977,2005,False,Never Qualified
Milwaukee Bucks,2964,6580,45.0,2639,5655,46.7,325,925,35.099999999999994,1720,2229,985,3390,1720,1132,7973,2005,False,Never Qualified
Minnesota Timberwolves,3045,6629,45.9,2650,5484,48.3,395,1145,34.5,1449,1820,947,3527,1918,1079,7934,2005,False,Never Qualified
Cleveland Cavaliers,2990,6687,44.7,2690,5783,46.5,300,904,33.2,1634,2174,1117,3469,1851,1141,7914,2005,False,Never Qualified
San Antonio Spurs,2923,6450,45.300000000000004,2416,5055,47.8,507,1395,36.3,1535,2120,987,3476,1771,1126,7888,2005,True,Champion
Los Angeles Clippers,2924,6368,45.9,2693,5699,47.3,231,669,34.5,1770,2274,980,3435,1901,1290,7849,2005,False,Never Qualified
Houston Rockets,2846,6419,44.3,2293,4898,46.800000000000004,553,1521,36.4,1551,1986,874,3475,1733,1135,7796,2005,True,Knocked Out
Chicago Bulls,2849,6592,43.2,2338,5159,45.300000000000004,511,1433,35.699999999999996,1536,2048,1001,3592,1743,1371,7745,2005,True,Knocked Out
Charlotte Hornets,2961,6859,43.2,2641,5978,44.2,320,881,36.3,1487,2096,1083,3418,1794,1192,7729,2005,False,Never Qualified
Memphis Grizzlies,2802,6271,44.7,2271,4785,47.5,531,1486,35.699999999999996,1526,2024,887,3194,1716,1197,7661,2005,True,Knocked Out
Detroit Pistons,2851,6421,44.4,2488,5368,46.300000000000004,363,1053,34.5,1588,2150,1054,3561,1787,1133,7653,2005,True,Runner-Up
Indiana Pacers,2668,6169,43.2,2126,4594,46.300000000000004,542,1575,34.4,1748,2206,868,3286,1489,1173,7626,2005,True,Knocked Out
Utah Jazz,2828,6301,44.9,2578,5539,46.5,250,762,32.800000000000004,1719,2272,1047,3290,1826,1292,7625,2005,False,Never Qualified
Portland Trail Blazers,2896,6422,45.1,2476,5261,47.099999999999994,420,1161,36.199999999999996,1409,1944,970,3374,1722,1308,7621,2005,False,Never Qualified
Atlanta Hawks,2942,6672,44.1,2638,5699,46.300000000000004,304,973,31.2,1417,1994,1100,3435,1614,1319,7605,2005,False,Never Qualified
Brooklyn Nets,2753,6419,42.9,2318,5216,44.4,435,1203,36.199999999999996,1555,2039,855,3242,1772,1164,7496,2005,True,Knocked Out
New Orleans Pelicans,2718,6556,41.5,2303,5240,44.0,415,1316,31.5,1401,1830,1019,3300,1724,1217,7252,2005,False,Never Qualified
Phoenix Suns,3430,7167,47.9,2593,5070,51.1,837,2097,39.900000000000006,1189,1475,778,3428,2179,1088,8886,2006,True,Knocked Out
Oklahoma City Thunder,3077,6711,45.9,2472,5080,48.699999999999996,605,1631,37.1,1652,2104,1013,3246,1696,1208,8411,2006,False,Never Qualified
Washington Wizards,2975,6656,44.7,2478,5262,47.099999999999994,497,1394,35.699999999999996,1889,2496,1035,3379,1523,1143,8336,2006,True,Knocked Out
Toronto Raptors,3013,6639,45.4,2405,5019,47.9,608,1620,37.5,1653,2089,864,3155,1593,1071,8287,2006,False,Never Qualified
Denver Nuggets,3078,6672,46.1,2728,5596,48.699999999999996,350,1076,32.5,1721,2312,903,3389,1921,1216,8227,2006,True,Knocked Out
Miami Heat,3039,6355,47.8,2542,4914,51.7,497,1441,34.5,1616,2310,858,3533,1692,1186,8191,2006,True,Champion
Los Angeles Lakers,2992,6607,45.300000000000004,2440,5024,48.6,552,1583,34.9,1618,2172,970,3458,1734,1143,8154,2006,True,Knocked Out
Philadelphia 76ers,3001,6546,45.800000000000004,2626,5515,47.599999999999994,375,1031,36.4,1770,2330,873,3298,1653,1159,8147,2006,False,Never Qualified
Dallas Mavericks,2948,6375,46.2,2532,5262,48.1,416,1113,37.4,1818,2322,1030,3461,1473,1112,8130,2006,True,Runner-Up
Sacramento Kings,2954,6500,45.4,2460,5092,48.3,494,1408,35.099999999999994,1704,2173,852,3325,1825,1199,8106,2006,True,Knocked Out
Golden State Warriors,2939,6785,43.3,2314,4953,46.7,625,1832,34.1,1573,2190,980,3465,1694,1156,8076,2006,False,Never Qualified
Boston Celtics,2951,6322,46.7,2484,5032,49.4,467,1290,36.199999999999996,1664,2204,813,3245,1716,1359,8033,2006,False,Never Qualified
Milwaukee Bucks,2976,6566,45.300000000000004,2469,5231,47.199999999999996,507,1335,38.0,1561,2115,929,3377,1769,1197,8020,2006,True,Knocked Out
Chicago Bulls,3004,6737,44.6,2444,5260,46.5,560,1477,37.9,1452,1967,906,3508,1804,1224,8020,2006,True,Knocked Out
Cleveland Cavaliers,2908,6412,45.4,2411,4947,48.699999999999996,497,1465,33.900000000000006,1689,2318,959,3470,1560,1137,8002,2006,True,Knocked Out
Atlanta Hawks,2946,6496,45.4,2522,5342,47.199999999999996,424,1154,36.7,1656,2207,1069,3301,1625,1284,7972,2006,False,Never Qualified
Los Angeles Clippers,2993,6443,46.5,2703,5600,48.3,290,843,34.4,1694,2142,828,3532,1708,1185,7970,2006,True,Knocked Out
Charlotte Hornets,2961,6843,43.3,2533,5582,45.4,428,1261,33.900000000000006,1593,2186,990,3260,1717,1167,7943,2006,False,Never Qualified
Detroit Pistons,2983,6558,45.5,2426,5107,47.5,557,1451,38.4,1418,1950,975,3322,1971,931,7941,2006,True,Knocked Out
New York Knicks,2822,6206,45.5,2502,5322,47.0,320,884,36.199999999999996,1878,2587,1034,3394,1468,1449,7842,2006,False,Never Qualified
San Antonio Spurs,2993,6342,47.199999999999996,2469,4980,49.6,524,1362,38.5,1327,1891,851,3399,1717,1126,7837,2006,True,Knocked Out
Orlando Magic,2911,6167,47.199999999999996,2612,5371,48.6,299,796,37.6,1663,2277,892,3294,1495,1240,7784,2006,False,Never Qualified
Indiana Pacers,2786,6274,44.4,2250,4738,47.5,536,1536,34.9,1591,2158,898,3457,1631,1254,7699,2006,True,Knocked Out
Brooklyn Nets,2778,6317,44.0,2301,4870,47.199999999999996,477,1447,33.0,1658,2187,822,3361,1884,1119,7691,2006,True,Knocked Out
New Orleans Pelicans,2831,6428,44.0,2531,5543,45.7,300,885,33.900000000000006,1649,2176,918,3297,1519,1095,7611,2006,False,Never Qualified
Utah Jazz,2744,6207,44.2,2433,5282,46.1,311,925,33.6,1774,2466,1071,3451,1772,1290,7573,2006,False,Never Qualified
Memphis Grizzlies,2746,6125,44.800000000000004,2156,4547,47.4,590,1578,37.4,1476,2077,834,3213,1586,1134,7558,2006,True,Knocked Out
Minnesota Timberwolves,2888,6340,45.6,2578,5398,47.8,310,942,32.9,1436,1895,811,3233,1716,1189,7522,2006,False,Never Qualified
Houston Rockets,2708,6252,43.3,2239,4838,46.300000000000004,469,1414,33.2,1502,1980,849,3414,1580,1193,7387,2006,False,Never Qualified
Portland Trail Blazers,2791,6267,44.5,2427,5225,46.400000000000006,364,1042,34.9,1339,1944,886,3089,1490,1205,7285,2006,False,Never Qualified
Phoenix Suns,3388,6855,49.4,2603,4890,53.2,785,1965,39.900000000000006,1476,1827,737,3320,2122,1189,9037,2007,True,Knocked Out
Golden State Warriors,3261,7048,46.300000000000004,2561,5081,50.4,700,1967,35.6,1515,2113,940,3396,1950,1309,8737,2007,True,Knocked Out
Denver Nuggets,3164,6805,46.5,2680,5365,50.0,484,1440,33.6,1827,2449,1001,3559,1920,1352,8639,2007,True,Knocked Out
Washington Wizards,3070,6820,45.0,2509,5206,48.199999999999996,561,1614,34.8,1855,2425,998,3377,1660,1133,8556,2007,True,Knocked Out
Los Angeles Lakers,3103,6664,46.6,2495,4940,50.5,608,1724,35.3,1660,2221,886,3381,1850,1273,8474,2007,True,Knocked Out
Memphis Grizzlies,2998,6448,46.5,2498,5086,49.1,500,1362,36.7,1835,2410,866,3241,1680,1343,8331,2007,False,Never Qualified
Utah Jazz,3069,6471,47.4,2715,5415,50.1,354,1056,33.5,1830,2462,1030,3486,2024,1277,8322,2007,True,Knocked Out
Sacramento Kings,2941,6532,45.0,2411,5019,48.0,530,1513,35.0,1891,2473,797,3193,1665,1194,8303,2007,False,Never Qualified
Dallas Mavericks,3010,6442,46.7,2475,5038,49.1,535,1404,38.1,1646,2045,920,3435,1632,1140,8201,2007,True,Knocked Out
Milwaukee Bucks,3121,6714,46.5,2597,5242,49.5,524,1472,35.6,1406,1919,941,3213,1771,1240,8172,2007,False,Never Qualified
Toronto Raptors,3032,6547,46.300000000000004,2501,5083,49.2,531,1464,36.3,1562,1982,755,3235,1822,1104,8157,2007,True,Knocked Out
Oklahoma City Thunder,3047,6628,46.0,2522,5177,48.699999999999996,525,1451,36.199999999999996,1511,1911,928,3250,1695,1268,8130,2007,False,Never Qualified
Chicago Bulls,3046,6663,45.7,2566,5426,47.3,480,1237,38.800000000000004,1528,2083,984,3581,1832,1310,8100,2007,True,Knocked Out
San Antonio Spurs,2999,6328,47.4,2404,4767,50.4,595,1561,38.1,1486,1980,761,3338,1814,1137,8079,2007,True,Champion
Brooklyn Nets,2913,6379,45.7,2304,4703,49.0,609,1676,36.3,1566,2153,822,3347,1962,1212,8001,2007,True,Knocked Out
New York Knicks,2903,6356,45.7,2429,4986,48.699999999999996,474,1370,34.599999999999994,1714,2396,1032,3548,1532,1405,7994,2007,False,Never Qualified
Houston Rockets,2906,6528,44.5,2201,4635,47.5,705,1893,37.2,1436,1906,880,3553,1704,1162,7953,2007,True,Knocked Out
Charlotte Hornets,2960,6643,44.6,2503,5363,46.7,457,1280,35.699999999999996,1568,2136,920,3266,1836,1224,7945,2007,False,Never Qualified
Cleveland Cavaliers,2978,6658,44.7,2484,5254,47.3,494,1404,35.199999999999996,1484,2133,1039,3568,1708,1177,7934,2007,True,Runner-Up
Minnesota Timberwolves,2997,6503,46.1,2613,5414,48.3,384,1089,35.3,1499,1892,819,3293,1848,1278,7877,2007,False,Never Qualified
Detroit Pistons,2942,6484,45.4,2493,5179,48.1,449,1305,34.4,1539,1988,948,3322,1768,1001,7872,2007,True,Knocked Out
Boston Celtics,2858,6454,44.3,2387,5171,46.2,471,1283,36.7,1670,2178,918,3309,1630,1350,7857,2007,False,Never Qualified
Los Angeles Clippers,2880,6318,45.6,2566,5415,47.4,314,903,34.8,1769,2245,888,3372,1762,1239,7843,2007,False,Never Qualified
Indiana Pacers,2872,6561,43.8,2391,5172,46.2,481,1389,34.599999999999994,1615,2125,990,3431,1680,1335,7840,2007,False,Never Qualified
New Orleans Pelicans,2971,6674,44.5,2516,5418,46.400000000000006,455,1256,36.199999999999996,1436,1941,1025,3537,1537,1187,7833,2007,False,Never Qualified
Philadelphia 76ers,2932,6408,45.800000000000004,2648,5585,47.4,284,823,34.5,1637,2135,899,3252,1669,1258,7785,2007,False,Never Qualified
Orlando Magic,2875,6090,47.199999999999996,2533,5128,49.4,342,962,35.6,1679,2393,920,3338,1525,1392,7771,2007,True,Knocked Out
Miami Heat,2919,6288,46.400000000000006,2391,4749,50.3,528,1539,34.300000000000004,1393,2019,817,3343,1681,1201,7759,2007,True,Knocked Out
Portland Trail Blazers,2874,6392,45.0,2448,5160,47.4,426,1232,34.599999999999994,1543,2006,923,3222,1513,1236,7717,2007,False,Never Qualified
Atlanta Hawks,2831,6372,44.4,2490,5334,46.7,341,1038,32.9,1677,2203,976,3288,1573,1306,7680,2007,False,Never Qualified
Golden State Warriors,3403,7406,45.9,2642,5221,50.6,761,2185,34.8,1538,2044,1045,3541,1833,1082,9105,2008,False,Never Qualified
Denver Nuggets,3307,7038,47.0,2738,5433,50.4,569,1605,35.5,1891,2519,918,3616,2024,1203,9074,2008,True,Knocked Out
Phoenix Suns,3392,6782,50.0,2698,5018,53.800000000000004,694,1764,39.300000000000004,1548,1977,720,3403,2188,1184,9026,2008,True,Knocked Out
Los Angeles Lakers,3248,6818,47.599999999999994,2586,5067,51.0,662,1751,37.8,1746,2270,898,3620,2003,1156,8904,2008,True,Runner-Up
Utah Jazz,3279,6592,49.7,2872,5497,52.2,407,1095,37.2,1745,2298,942,3352,2165,1200,8710,2008,True,Knocked Out
Orlando Magic,3058,6446,47.4,2257,4372,51.6,801,2074,38.6,1650,2288,768,3445,1706,1173,8567,2008,True,Knocked Out
Indiana Pacers,3102,6993,44.4,2347,4972,47.199999999999996,755,2021,37.4,1568,2042,904,3537,1864,1236,8527,2008,False,Never Qualified
Sacramento Kings,3043,6558,46.400000000000006,2533,5191,48.8,510,1367,37.3,1812,2272,829,3285,1567,1317,8408,2008,False,Never Qualified
New Orleans Pelicans,3164,6796,46.6,2534,5175,49.0,630,1621,38.9,1312,1707,937,3431,1785,974,8270,2008,True,Knocked Out
Memphis Grizzlies,3060,6737,45.4,2440,4958,49.2,620,1779,34.9,1517,2097,848,3415,1574,1251,8257,2008,False,Never Qualified
Boston Celtics,2986,6286,47.5,2390,4722,50.6,596,1564,38.1,1677,2176,830,3445,1833,1246,8245,2008,True,Champion
Dallas Mavericks,3025,6515,46.400000000000006,2531,5112,49.5,494,1403,35.199999999999996,1690,2075,883,3526,1720,1037,8234,2008,True,Knocked Out
Toronto Raptors,3148,6726,46.800000000000004,2576,5267,48.9,572,1459,39.2,1347,1658,790,3286,1953,959,8215,2008,True,Knocked Out
Washington Wizards,2986,6695,44.6,2411,5081,47.5,575,1614,35.6,1557,1991,1007,3411,1607,1082,8104,2008,True,Knocked Out
Atlanta Hawks,2975,6552,45.4,2591,5474,47.3,384,1078,35.6,1720,2227,1008,3462,1804,1223,8054,2008,True,Knocked Out
Oklahoma City Thunder,3125,7032,44.4,2812,6093,46.2,313,939,33.300000000000004,1436,1866,971,3659,1748,1310,7999,2008,False,Never Qualified
Detroit Pistons,2999,6551,45.800000000000004,2512,5221,48.1,487,1330,36.6,1507,1965,974,3397,1831,956,7992,2008,True,Knocked Out
Chicago Bulls,2987,6861,43.5,2513,5556,45.2,474,1305,36.3,1533,2029,1050,3528,1811,1197,7981,2008,False,Never Qualified
Charlotte Hornets,2960,6554,45.2,2431,5111,47.599999999999994,529,1443,36.7,1510,2115,892,3332,1748,1204,7959,2008,False,Never Qualified
Milwaukee Bucks,3026,6745,44.9,2574,5432,47.4,452,1313,34.4,1452,1980,1055,3418,1760,1210,7956,2008,False,Never Qualified
New York Knicks,2967,6757,43.9,2477,5303,46.7,490,1454,33.7,1524,2095,1029,3486,1530,1187,7948,2008,False,Never Qualified
Houston Rockets,3003,6698,44.800000000000004,2420,4991,48.5,583,1707,34.2,1342,1848,1002,3661,1757,1125,7931,2008,True,Knocked Out
Philadelphia 76ers,3056,6648,46.0,2754,5696,48.3,302,952,31.7,1509,2137,1067,3437,1673,1172,7923,2008,True,Knocked Out
Cleveland Cavaliers,2937,6697,43.9,2385,5153,46.300000000000004,552,1544,35.8,1477,2061,1092,3655,1640,1145,7903,2008,True,Knocked Out
Brooklyn Nets,2856,6450,44.3,2358,5020,47.0,498,1430,34.8,1647,2237,913,3433,1925,1229,7857,2008,False,Never Qualified
Minnesota Timberwolves,3076,6817,45.1,2635,5558,47.4,441,1259,35.0,1246,1693,964,3392,1630,1188,7839,2008,False,Never Qualified
Portland Trail Blazers,2935,6546,44.800000000000004,2397,5120,46.800000000000004,538,1426,37.7,1412,1841,901,3339,1733,1056,7820,2008,False,Never Qualified
San Antonio Spurs,2938,6424,45.7,2344,4814,48.699999999999996,594,1610,36.9,1350,1774,771,3383,1718,1035,7820,2008,True,Knocked Out
Los Angeles Clippers,2820,6445,43.8,2470,5366,46.0,350,1079,32.4,1702,2178,800,3291,1732,1180,7692,2008,False,Never Qualified
Miami Heat,2808,6336,44.3,2317,4963,46.7,491,1373,35.8,1384,1903,743,3085,1644,1202,7491,2008,False,Never Qualified
Phoenix Suns,3373,6695,50.4,2820,5250,53.7,553,1445,38.3,1675,2251,900,3420,1905,1288,8974,2009,False,Never Qualified
Golden State Warriors,3231,7055,45.800000000000004,2681,5580,48.0,550,1475,37.3,1893,2392,953,3445,1711,1201,8905,2009,False,Never Qualified
Los Angeles Lakers,3307,6981,47.4,2760,5465,50.5,547,1516,36.1,1607,2087,1015,3602,1908,1103,8768,2009,True,Champion
New York Knicks,3157,7091,44.5,2334,4807,48.6,823,2284,36.0,1490,1900,911,3456,1738,1174,8627,2009,False,Never Qualified
Indiana Pacers,3220,7080,45.5,2568,5355,48.0,652,1725,37.8,1525,1890,924,3585,1775,1189,8617,2009,False,Never Qualified
Denver Nuggets,3058,6510,47.0,2510,5033,49.9,548,1477,37.1,1891,2487,905,3412,1820,1257,8555,2009,True,Knocked Out
Utah Jazz,3143,6623,47.5,2751,5501,50.0,392,1122,34.9,1814,2352,940,3363,2024,1210,8492,2009,True,Knocked Out
Chicago Bulls,3126,6846,45.7,2633,5553,47.4,493,1293,38.1,1633,2052,970,3451,1732,1192,8378,2009,True,Knocked Out
Dallas Mavericks,3128,6770,46.2,2557,5138,49.8,571,1632,35.0,1516,1852,909,3504,1779,1043,8343,2009,True,Knocked Out
Orlando Magic,2929,6416,45.7,2112,4269,49.5,817,2147,38.1,1611,2253,819,3547,1593,1142,8286,2009,True,Runner-Up
Boston Celtics,3075,6333,48.6,2537,4978,51.0,538,1355,39.7,1587,2075,869,3455,1862,1280,8275,2009,True,Knocked Out
Sacramento Kings,2990,6685,44.7,2404,5091,47.199999999999996,586,1594,36.8,1682,2107,840,3206,1619,1266,8248,2009,False,Never Qualified
Cleveland Cavaliers,3022,6454,46.800000000000004,2366,4784,49.5,656,1670,39.300000000000004,1523,2012,886,3460,1663,1045,8223,2009,True,Knocked Out
Portland Trail Blazers,3018,6494,46.5,2422,4939,49.0,596,1555,38.3,1521,1988,1060,3420,1667,1055,8153,2009,True,Knocked Out
Milwaukee Bucks,3009,6755,44.5,2498,5347,46.7,511,1408,36.3,1613,2067,973,3340,1802,1154,8142,2009,False,Never Qualified
Toronto Raptors,3054,6673,45.800000000000004,2575,5384,47.8,479,1289,37.2,1534,1861,802,3315,1835,1098,8121,2009,False,Never Qualified
Houston Rockets,2959,6526,45.300000000000004,2338,4870,48.0,621,1656,37.5,1531,1903,862,3524,1662,1158,8070,2009,True,Knocked Out
Miami Heat,3034,6646,45.7,2452,5015,48.9,582,1631,35.699999999999996,1411,1871,828,3239,1671,1026,8061,2009,True,Knocked Out
Atlanta Hawks,2956,6451,45.800000000000004,2359,4818,49.0,597,1633,36.6,1537,2085,870,3282,1657,1048,8046,2009,True,Knocked Out
Brooklyn Nets,2925,6536,44.800000000000004,2273,4801,47.3,652,1735,37.6,1542,1980,850,3265,1636,1075,8044,2009,False,Never Qualified
Minnesota Timberwolves,2986,6766,44.1,2443,5227,46.7,543,1539,35.3,1504,1957,975,3417,1674,1165,8019,2009,False,Never Qualified
Philadelphia 76ers,2997,6532,45.9,2656,5460,48.6,341,1072,31.8,1652,2216,1039,3375,1647,1157,7987,2009,True,Knocked Out
San Antonio Spurs,3042,6534,46.6,2417,4914,49.2,625,1620,38.6,1249,1641,728,3366,1736,963,7958,2009,True,Knocked Out
Oklahoma City Thunder,2999,6716,44.7,2671,5767,46.300000000000004,328,949,34.599999999999994,1626,2069,999,3496,1663,1330,7952,2009,False,Never Qualified
Washington Wizards,2994,6655,45.0,2599,5457,47.599999999999994,395,1198,33.0,1494,1948,956,3286,1641,1146,7877,2009,False,Never Qualified
New Orleans Pelicans,2911,6366,45.7,2355,4840,48.699999999999996,556,1526,36.4,1479,1833,802,3255,1609,1029,7857,2009,True,Knocked Out
Los Angeles Clippers,2955,6696,44.1,2420,5183,46.7,535,1513,35.4,1354,1839,890,3267,1723,1221,7799,2009,False,Never Qualified
Detroit Pistons,2981,6559,45.4,2604,5480,47.5,377,1079,34.9,1388,1849,949,3397,1689,973,7727,2009,True,Knocked Out
Memphis Grizzlies,2865,6311,45.4,2467,5205,47.4,398,1106,36.0,1570,2077,847,3184,1423,1252,7698,2009,False,Never Qualified
Charlotte Hornets,2866,6299,45.5,2376,4960,47.9,490,1339,36.6,1455,1965,886,3252,1741,1279,7677,2009,False,Never Qualified
Phoenix Suns,3339,6788,49.2,2609,5018,52.0,730,1770,41.199999999999996,1631,2117,910,3526,1912,1210,9039,2010,True,Knocked Out
Golden State Warriors,3329,7094,46.9,2696,5407,49.9,633,1687,37.5,1631,2085,753,3150,1839,1204,8922,2010,False,Never Qualified
Denver Nuggets,3124,6678,46.800000000000004,2580,5161,50.0,544,1517,35.9,1937,2508,889,3394,1719,1136,8729,2010,True,Knocked Out
Utah Jazz,3227,6575,49.1,2788,5368,51.9,439,1207,36.4,1654,2233,872,3460,2187,1246,8547,2010,True,Knocked Out
Toronto Raptors,3199,6631,48.199999999999996,2681,5234,51.2,518,1397,37.1,1618,2118,806,3313,1804,1100,8534,2010,False,Never Qualified
Orlando Magic,3005,6394,47.0,2164,4153,52.1,841,2241,37.5,1575,2176,810,3546,1615,1155,8426,2010,True,Knocked Out
Memphis Grizzlies,3223,6875,46.9,2879,5855,49.2,344,1020,33.7,1614,2202,1070,3566,1543,1248,8404,2010,False,Never Qualified
Houston Rockets,3094,6923,44.7,2448,5085,48.1,646,1838,35.099999999999994,1561,2022,971,3442,1790,1188,8395,2010,False,Never Qualified
New York Knicks,3127,6876,45.5,2384,4731,50.4,743,2145,34.599999999999994,1376,1759,836,3313,1772,1148,8373,2010,False,Never Qualified
Cleveland Cavaliers,3101,6391,48.5,2499,4809,52.0,602,1582,38.1,1569,2180,791,3483,1835,1137,8373,2010,True,Knocked Out
Dallas Mavericks,3140,6760,46.400000000000006,2582,5262,49.1,558,1498,37.2,1526,1870,834,3420,1917,1059,8364,2010,True,Knocked Out
Los Angeles Lakers,3144,6875,45.7,2612,5313,49.2,532,1562,34.1,1519,1985,973,3635,1730,1096,8339,2010,True,Champion
Atlanta Hawks,3181,6801,46.800000000000004,2657,5346,49.7,524,1455,36.0,1452,1914,969,3420,1789,980,8338,2010,True,Knocked Out
Oklahoma City Thunder,3063,6629,46.2,2645,5400,49.0,418,1229,34.0,1778,2210,960,3567,1639,1227,8322,2010,True,Knocked Out
San Antonio Spurs,3150,6659,47.3,2596,5112,50.8,554,1547,35.8,1458,1969,887,3508,1829,1116,8312,2010,True,Knocked Out
Indiana Pacers,3020,6823,44.3,2361,4927,47.9,659,1896,34.8,1564,2019,785,3403,1730,1232,8263,2010,False,Never Qualified
New Orleans Pelicans,3178,6842,46.400000000000006,2607,5270,49.5,571,1572,36.3,1293,1661,852,3302,1828,1103,8220,2010,False,Never Qualified
Sacramento Kings,3144,6895,45.6,2662,5512,48.3,482,1383,34.9,1430,1969,977,3495,1679,1226,8200,2010,False,Never Qualified
Boston Celtics,3039,6294,48.3,2540,4861,52.300000000000004,499,1433,34.8,1559,2090,716,3165,1930,1219,8136,2010,True,Runner-Up
Minnesota Timberwolves,3106,6923,44.9,2703,5742,47.099999999999994,403,1181,34.1,1436,1926,962,3518,1626,1333,8051,2010,False,Never Qualified
Portland Trail Blazers,2974,6453,46.1,2483,5065,49.0,491,1388,35.4,1606,2033,913,3296,1674,1012,8045,2010,True,Knocked Out
Philadelphia 76ers,3087,6706,46.0,2613,5325,49.1,474,1381,34.300000000000004,1366,1808,941,3362,1723,1192,8014,2010,False,Never Qualified
Milwaukee Bucks,3050,6998,43.6,2405,5185,46.400000000000006,645,1813,35.6,1264,1675,965,3525,1740,1085,8009,2010,True,Knocked Out
Chicago Bulls,3081,6825,45.1,2729,5759,47.4,352,1066,33.0,1479,1962,937,3652,1704,1175,7993,2010,True,Knocked Out
Miami Heat,2984,6518,45.800000000000004,2490,5092,48.9,494,1426,34.599999999999994,1452,1931,875,3428,1548,1079,7914,2010,True,Knocked Out
Washington Wizards,3008,6700,44.9,2576,5475,47.099999999999994,432,1225,35.3,1444,1895,966,3424,1557,1219,7892,2010,False,Never Qualified
Los Angeles Clippers,3002,6601,45.5,2519,5144,49.0,483,1457,33.2,1362,1867,927,3429,1810,1285,7849,2010,False,Never Qualified
Charlotte Hornets,2858,6306,45.300000000000004,2398,4975,48.199999999999996,460,1331,34.599999999999994,1637,2180,858,3348,1658,1290,7813,2010,True,Knocked Out
Detroit Pistons,2940,6602,44.5,2566,5412,47.4,374,1190,31.4,1455,1998,1053,3295,1591,1100,7709,2010,False,Never Qualified
Brooklyn Nets,2813,6554,42.9,2436,5369,45.4,377,1185,31.8,1572,2015,897,3255,1540,1182,7575,2010,False,Never Qualified
Denver Nuggets,3145,6613,47.599999999999994,2483,4909,50.6,662,1704,38.800000000000004,1859,2429,791,3443,1813,1157,8811,2011,True,Knocked Out
New York Knicks,3140,6867,45.7,2375,4786,49.6,765,2081,36.8,1689,2087,847,3317,1757,1123,8734,2011,True,Knocked Out
Houston Rockets,3170,6975,45.4,2493,5132,48.6,677,1843,36.7,1668,2083,962,3511,1955,1110,8685,2011,False,Never Qualified
Phoenix Suns,3219,6844,47.0,2518,4987,50.5,701,1857,37.7,1472,1939,821,3299,1945,1169,8611,2011,False,Never Qualified
Oklahoma City Thunder,3066,6609,46.400000000000006,2579,5206,49.5,487,1403,34.699999999999996,1977,2401,903,3507,1672,1156,8596,2011,True,Knocked Out
San Antonio Spurs,3148,6628,47.5,2463,4901,50.3,685,1727,39.7,1521,1984,829,3432,1836,1101,8502,2011,True,Knocked Out
Golden State Warriors,3251,7047,46.1,2566,5298,48.4,685,1749,39.2,1290,1695,955,3325,1847,1198,8477,2011,False,Never Qualified
Miami Heat,3031,6301,48.1,2484,4822,51.5,547,1479,37.0,1760,2288,790,3456,1639,1142,8369,2011,True,Runner-Up
Los Angeles Lakers,3128,6757,46.300000000000004,2604,5270,49.4,524,1487,35.199999999999996,1541,1979,989,3605,1801,1073,8321,2011,True,Knocked Out
Minnesota Timberwolves,3090,7014,44.1,2501,5449,45.9,589,1565,37.6,1519,1977,1085,3641,1650,1398,8288,2011,False,Never Qualified
Dallas Mavericks,3069,6463,47.5,2424,4695,51.6,645,1768,36.5,1437,1850,780,3398,1954,1145,8220,2011,True,Champion
Memphis Grizzlies,3200,6801,47.099999999999994,2891,5875,49.2,309,926,33.4,1486,1981,970,3361,1691,1145,8195,2011,True,Knocked Out
Indiana Pacers,3003,6787,44.2,2418,5134,47.099999999999994,585,1653,35.4,1592,2035,914,3571,1611,1262,8183,2011,True,Knocked Out
Utah Jazz,3064,6590,46.5,2629,5334,49.3,435,1256,34.599999999999994,1590,2061,898,3236,1921,1175,8153,2011,False,Never Qualified
Sacramento Kings,3134,6979,44.9,2706,5702,47.5,428,1277,33.5,1455,1981,1071,3597,1675,1324,8151,2011,False,Never Qualified
Orlando Magic,2956,6411,46.1,2186,4308,50.7,770,2103,36.6,1453,2101,864,3543,1636,1224,8135,2011,True,Knocked Out
Toronto Raptors,3144,6755,46.5,2799,5664,49.4,345,1091,31.6,1491,1976,963,3306,1795,1206,8124,2011,False,Never Qualified
Philadelphia 76ers,3125,6776,46.1,2682,5528,48.5,443,1248,35.5,1426,1851,850,3428,1861,1063,8119,2011,True,Knocked Out
Los Angeles Clippers,3015,6594,45.7,2502,5075,49.3,513,1519,33.800000000000004,1546,2187,955,3456,1813,1343,8089,2011,False,Never Qualified
Chicago Bulls,3042,6587,46.2,2531,5172,48.9,511,1415,36.1,1492,2008,967,3621,1827,1161,8087,2011,True,Knocked Out
Washington Wizards,3048,6888,44.3,2656,5706,46.5,392,1182,33.2,1489,1999,1013,3387,1592,1258,7977,2011,False,Never Qualified
Detroit Pistons,3056,6647,46.0,2584,5391,47.9,472,1256,37.6,1367,1854,931,3167,1730,1067,7951,2011,False,Never Qualified
Boston Celtics,3023,6219,48.6,2615,5100,51.300000000000004,408,1119,36.5,1459,1895,639,3181,1921,1195,7913,2011,True,Knocked Out
Portland Trail Blazers,2951,6599,44.7,2433,5096,47.699999999999996,518,1503,34.5,1476,1835,996,3226,1736,1070,7896,2011,True,Knocked Out
Cleveland Cavaliers,2886,6647,43.4,2377,5158,46.1,509,1489,34.2,1546,2075,856,3305,1720,1166,7827,2011,False,Never Qualified
Atlanta Hawks,2971,6429,46.2,2469,5002,49.4,502,1427,35.199999999999996,1346,1728,762,3222,1802,1118,7790,2011,True,Knocked Out
New Orleans Pelicans,2944,6416,45.9,2500,5184,48.199999999999996,444,1232,36.0,1452,1897,824,3292,1691,1069,7784,2011,True,Knocked Out
Brooklyn Nets,2918,6638,44.0,2459,5301,46.400000000000006,459,1337,34.300000000000004,1427,1881,909,3349,1723,1152,7722,2011,False,Never Qualified
Charlotte Hornets,2873,6365,45.1,2480,5162,48.0,393,1203,32.7,1511,1999,848,3292,1728,1192,7650,2011,False,Never Qualified
Milwaukee Bucks,2814,6544,43.0,2331,5130,45.4,483,1414,34.2,1423,1881,862,3342,1545,1103,7534,2011,False,Never Qualified
Denver Nuggets,2572,5404,47.599999999999994,2137,4093,52.2,435,1311,33.2,1293,1760,738,2843,1581,1015,6872,2012,True,Knocked Out
San Antonio Spurs,2611,5463,47.8,2059,4058,50.7,552,1405,39.300000000000004,1067,1427,683,2836,1528,895,6841,2012,True,Knocked Out
Oklahoma City Thunder,2462,5229,47.099999999999994,1990,3912,50.9,472,1317,35.8,1406,1744,726,2883,1224,1079,6802,2012,True,Runner-Up
Utah Jazz,2523,5531,45.6,2250,4686,48.0,273,845,32.300000000000004,1258,1668,861,2916,1439,936,6577,2012,True,Knocked Out
Milwaukee Bucks,2502,5652,44.3,2066,4387,47.099999999999994,436,1265,34.5,1095,1415,820,2803,1550,929,6535,2012,False,Never Qualified
Sacramento Kings,2490,5712,43.6,2079,4411,47.099999999999994,411,1301,31.6,1127,1532,882,2829,1271,952,6518,2012,False,Never Qualified
Miami Heat,2446,5212,46.9,2076,4182,49.6,370,1030,35.9,1238,1598,686,2746,1317,1002,6500,2012,True,Champion
Phoenix Suns,2495,5445,45.800000000000004,2051,4150,49.4,444,1295,34.300000000000004,1058,1397,717,2752,1486,928,6492,2012,False,Never Qualified
Houston Rockets,2489,5543,44.9,2011,4213,47.699999999999996,478,1330,35.9,1018,1301,769,2783,1404,955,6474,2012,False,Never Qualified
Minnesota Timberwolves,2355,5434,43.3,1882,4011,46.9,473,1423,33.2,1281,1662,797,2886,1290,1001,6464,2012,False,Never Qualified
New York Knicks,2365,5335,44.3,1848,3797,48.699999999999996,517,1538,33.6,1211,1634,743,2755,1328,1056,6458,2012,True,Knocked Out
Golden State Warriors,2489,5443,45.7,1965,4092,48.0,524,1351,38.800000000000004,951,1235,640,2587,1470,915,6453,2012,False,Never Qualified
Indiana Pacers,2354,5375,43.8,1962,4311,45.5,392,1064,36.8,1349,1724,826,2896,1228,925,6449,2012,True,Knocked Out
Los Angeles Clippers,2439,5366,45.5,1925,3925,49.0,514,1441,35.699999999999996,1046,1538,800,2743,1385,879,6438,2012,True,Knocked Out
Los Angeles Lakers,2429,5319,45.7,2067,4207,49.1,362,1112,32.6,1202,1589,799,3050,1485,997,6422,2012,True,Knocked Out
Portland Trail Blazers,2402,5417,44.3,1924,4035,47.699999999999996,478,1382,34.599999999999994,1133,1423,735,2684,1349,935,6415,2012,False,Never Qualified
Atlanta Hawks,2429,5348,45.4,1937,4018,48.199999999999996,492,1330,37.0,1025,1385,652,2718,1481,921,6375,2012,True,Knocked Out
Chicago Bulls,2467,5462,45.2,2048,4345,47.099999999999994,419,1117,37.5,1006,1394,915,3080,1527,923,6359,2012,True,Knocked Out
Dallas Mavericks,2398,5412,44.3,1901,3948,48.199999999999996,497,1464,33.900000000000006,1029,1334,665,2822,1380,926,6322,2012,True,Knocked Out
Memphis Grizzlies,2425,5422,44.7,2148,4573,47.0,277,849,32.6,1142,1504,831,2775,1290,955,6269,2012,True,Knocked Out
Orlando Magic,2275,5162,44.1,1605,3377,47.5,670,1785,37.5,995,1508,742,2802,1321,984,6215,2012,True,Knocked Out
Washington Wizards,2414,5475,44.1,2070,4400,47.0,344,1075,32.0,1008,1386,775,2750,1262,1008,6180,2012,False,Never Qualified
Philadelphia 76ers,2471,5516,44.800000000000004,2122,4553,46.6,349,963,36.199999999999996,889,1198,704,2848,1453,738,6180,2012,True,Knocked Out
Brooklyn Nets,2262,5320,42.5,1755,3839,45.7,507,1481,34.2,1113,1433,783,2662,1311,995,6144,2012,False,Never Qualified
Cleveland Cavaliers,2261,5360,42.199999999999996,1821,4087,44.6,440,1273,34.599999999999994,1178,1645,841,2790,1308,1017,6140,2012,False,Never Qualified
Boston Celtics,2341,5086,46.0,1978,4098,48.3,363,988,36.7,1017,1308,509,2560,1557,979,6062,2012,True,Knocked Out
Detroit Pistons,2291,5232,43.8,1974,4316,45.7,317,916,34.599999999999994,1098,1461,775,2657,1232,1033,5997,2012,False,Never Qualified
Toronto Raptors,2268,5154,44.0,1903,4079,46.7,365,1075,34.0,1085,1410,697,2771,1382,1001,5986,2012,False,Never Qualified
New Orleans Pelicans,2300,5103,45.1,2041,4326,47.199999999999996,259,777,33.300000000000004,1057,1397,724,2715,1368,1024,5916,2012,False,Never Qualified
Charlotte Hornets,2193,5293,41.4,1930,4401,43.9,263,892,29.5,1090,1462,677,2571,1326,957,5739,2012,False,Never Qualified
Denver Nuggets,3339,6983,47.8,2818,5465,51.6,521,1518,34.300000000000004,1505,2148,1092,3693,2002,1253,8704,2013,True,Knocked Out
Houston Rockets,3124,6782,46.1,2257,4413,51.1,867,2369,36.6,1573,2087,909,3561,1902,1348,8688,2013,True,Knocked Out
Oklahoma City Thunder,3126,6504,48.1,2528,4916,51.4,598,1588,37.7,1819,2196,854,3579,1753,1253,8669,2013,True,Knocked Out
San Antonio Spurs,3210,6675,48.1,2547,4911,51.9,663,1764,37.6,1365,1725,666,3387,2058,1206,8448,2013,True,Runner-Up
Miami Heat,3148,6348,49.6,2431,4539,53.6,717,1809,39.6,1423,1887,676,3166,1890,1143,8436,2013,True,Champion
Los Angeles Lakers,3041,6640,45.800000000000004,2326,4625,50.3,715,2015,35.5,1584,2289,942,3674,1818,1232,8381,2013,True,Knocked Out
Golden State Warriors,3130,6840,45.800000000000004,2472,5208,47.5,658,1632,40.300000000000004,1378,1744,885,3686,1845,1236,8296,2013,True,Knocked Out
Dallas Mavericks,3182,6892,46.2,2576,5264,48.9,606,1628,37.2,1323,1669,767,3437,1906,1144,8293,2013,False,Never Qualified
Los Angeles Clippers,3160,6608,47.8,2533,4856,52.2,627,1752,35.8,1342,1888,938,3413,1958,1197,8289,2013,True,Knocked Out
Sacramento Kings,3086,6904,44.7,2476,5223,47.4,610,1681,36.3,1437,1869,943,3328,1708,1199,8219,2013,False,Never Qualified
New York Knicks,2996,6689,44.800000000000004,2105,4318,48.699999999999996,891,2371,37.6,1313,1729,890,3326,1579,988,8196,2013,True,Knocked Out
Milwaukee Bucks,3128,7197,43.5,2527,5527,45.7,601,1670,36.0,1251,1700,1068,3605,1876,1156,8108,2013,True,Knocked Out
Utah Jazz,3046,6710,45.4,2539,5325,47.699999999999996,507,1385,36.6,1439,1883,989,3446,1859,1210,8038,2013,False,Never Qualified
Atlanta Hawks,3084,6644,46.400000000000006,2378,4743,50.1,706,1901,37.1,1158,1619,758,3351,2007,1219,8032,2013,True,Knocked Out
Portland Trail Blazers,3009,6715,44.800000000000004,2336,4811,48.6,673,1904,35.3,1304,1680,874,3348,1784,1203,7995,2013,False,Never Qualified
Toronto Raptors,2979,6685,44.6,2408,5020,48.0,571,1665,34.300000000000004,1442,1831,871,3297,1765,1124,7971,2013,False,Never Qualified
Brooklyn Nets,2942,6544,45.0,2314,4784,48.4,628,1760,35.699999999999996,1432,1958,1047,3507,1668,1206,7944,2013,True,Knocked Out
Cleveland Cavaliers,2993,6901,43.4,2446,5320,46.0,547,1581,34.599999999999994,1380,1826,1004,3363,1694,1149,7913,2013,False,Never Qualified
Minnesota Timberwolves,2943,6702,43.9,2493,5227,47.699999999999996,450,1475,30.5,1515,2042,973,3446,1836,1214,7851,2013,False,Never Qualified
Boston Celtics,3001,6459,46.5,2503,5069,49.4,498,1390,35.8,1318,1698,654,3187,1843,1181,7818,2013,True,Knocked Out
Phoenix Suns,3061,6917,44.3,2581,5462,47.3,480,1455,33.0,1203,1618,959,3413,1855,1278,7805,2013,False,Never Qualified
Detroit Pistons,2979,6638,44.9,2466,5198,47.4,513,1440,35.6,1307,1870,991,3454,1742,1241,7778,2013,False,Never Qualified
Orlando Magic,3093,6904,44.800000000000004,2587,5367,48.199999999999996,506,1537,32.9,1026,1359,890,3502,1871,1191,7718,2013,False,Never Qualified
New Orleans Pelicans,2955,6589,44.800000000000004,2420,5115,47.3,535,1474,36.3,1269,1636,988,3414,1721,1193,7714,2013,False,Never Qualified
Indiana Pacers,2845,6525,43.6,2290,4926,46.5,555,1599,34.699999999999996,1429,1915,1043,3714,1645,1227,7674,2013,True,Knocked Out
Charlotte Hornets,2823,6649,42.5,2354,5250,44.800000000000004,469,1399,33.5,1546,2060,917,3306,1587,1153,7661,2013,False,Never Qualified
Memphis Grizzlies,2964,6679,44.4,2582,5572,46.300000000000004,382,1107,34.5,1349,1746,1059,3504,1715,1144,7659,2013,True,Knocked Out
Washington Wizards,2910,6693,43.5,2365,5198,45.5,545,1495,36.5,1279,1746,887,3539,1775,1238,7644,2013,False,Never Qualified
Chicago Bulls,2926,6698,43.7,2480,5433,45.6,446,1265,35.3,1343,1738,1026,3540,1886,1171,7641,2013,True,Knocked Out
Philadelphia 76ers,3059,6895,44.4,2541,5457,46.6,518,1438,36.0,1004,1377,896,3389,1867,1070,7640,2013,False,Never Qualified
Los Angeles Clippers,3208,6761,47.4,2515,4795,52.5,693,1966,35.199999999999996,1741,2384,858,3526,2016,1136,8850,2014,True,Knocked Out
Houston Rockets,3118,6603,47.199999999999996,2339,4424,52.900000000000006,779,2179,35.8,1814,2549,920,3717,1755,1323,8829,2014,True,Knocked Out
Minnesota Timberwolves,3189,7175,44.4,2589,5418,47.8,600,1757,34.1,1790,2301,1024,3668,1963,1142,8768,2014,False,Never Qualified
Portland Trail Blazers,3207,7134,45.0,2437,5063,48.1,770,2071,37.2,1569,1926,1022,3808,1904,1125,8753,2014,True,Knocked Out
Oklahoma City Thunder,3194,6782,47.099999999999994,2530,4943,51.2,664,1839,36.1,1653,2052,887,3668,1794,1256,8705,2014,True,Knocked Out
San Antonio Spurs,3326,6844,48.6,2628,5087,51.7,698,1757,39.7,1289,1642,762,3548,2064,1180,8639,2014,True,Champion
Phoenix Suns,3172,6845,46.300000000000004,2407,4790,50.3,765,2055,37.2,1520,2004,928,3529,1563,1258,8629,2014,False,Never Qualified
Dallas Mavericks,3249,6858,47.4,2528,4981,50.8,721,1877,38.4,1378,1733,840,3354,1935,1110,8597,2014,True,Knocked Out
Denver Nuggets,3147,7042,44.7,2445,5083,48.1,702,1959,35.8,1563,2154,1009,3726,1838,1305,8559,2014,False,Never Qualified
Golden State Warriors,3236,7005,46.2,2462,4968,49.6,774,2037,38.0,1303,1731,896,3715,1912,1247,8549,2014,True,Knocked Out
Los Angeles Lakers,3139,6980,45.0,2365,4948,47.8,774,2032,38.1,1390,1835,745,3365,2006,1239,8442,2014,False,Never Qualified
Miami Heat,3142,6272,50.1,2477,4443,55.800000000000004,665,1829,36.4,1431,1884,627,3024,1847,1212,8380,2014,True,Runner-Up
Toronto Raptors,2992,6718,44.5,2279,4801,47.5,713,1917,37.2,1608,2055,935,3487,1737,1159,8305,2014,True,Knocked Out
Detroit Pistons,3182,7124,44.7,2675,5544,48.3,507,1580,32.1,1415,2111,1196,3721,1714,1193,8286,2014,False,Never Qualified
Atlanta Hawks,3061,6688,45.800000000000004,2293,4572,50.2,768,2116,36.3,1392,1782,713,3278,2041,1251,8282,2014,True,Knocked Out
Washington Wizards,3177,6920,45.9,2530,5216,48.5,647,1704,38.0,1253,1715,886,3459,1909,1204,8254,2014,True,Knocked Out
Sacramento Kings,3026,6766,44.7,2535,5291,47.9,491,1475,33.300000000000004,1698,2237,990,3646,1547,1249,8241,2014,False,Never Qualified
New Orleans Pelicans,3101,6761,45.9,2615,5458,47.9,486,1303,37.3,1489,1936,933,3419,1745,1129,8177,2014,False,Never Qualified
Philadelphia 76ers,3108,7150,43.5,2531,5303,47.699999999999996,577,1847,31.2,1362,1918,949,3505,1791,1384,8155,2014,False,Never Qualified
New York Knicks,3027,6739,44.9,2268,4701,48.199999999999996,759,2038,37.2,1271,1670,870,3307,1641,1063,8084,2014,False,Never Qualified
Brooklyn Nets,2931,6391,45.9,2222,4469,49.7,709,1922,36.9,1508,2002,721,3128,1714,1191,8079,2014,True,Knocked Out
Cleveland Cavaliers,3036,6955,43.7,2452,5315,46.1,584,1640,35.6,1398,1861,989,3618,1738,1163,8054,2014,False,Never Qualified
Charlotte Hornets,2976,6730,44.2,2460,5259,46.800000000000004,516,1471,35.099999999999994,1474,2000,776,3500,1778,1010,7942,2014,True,Knocked Out
Indiana Pacers,2949,6573,44.9,2399,5031,47.699999999999996,550,1542,35.699999999999996,1485,1907,834,3665,1651,1237,7933,2014,True,Knocked Out
Orlando Magic,3022,6784,44.5,2459,5188,47.4,563,1596,35.3,1307,1714,794,3448,1726,1222,7914,2014,False,Never Qualified
Boston Celtics,2996,6883,43.5,2421,5154,47.0,575,1729,33.300000000000004,1325,1706,980,3485,1726,1261,7892,2014,False,Never Qualified
Memphis Grizzlies,3122,6723,46.400000000000006,2717,5576,48.699999999999996,405,1147,35.3,1235,1666,950,3476,1792,1124,7884,2014,True,Knocked Out
Milwaukee Bucks,2952,6737,43.8,2404,5184,46.400000000000006,548,1553,35.3,1377,1843,971,3370,1760,1238,7829,2014,False,Never Qualified
Utah Jazz,2951,6652,44.4,2408,5075,47.4,543,1577,34.4,1346,1803,904,3381,1664,1200,7791,2014,False,Never Qualified
Chicago Bulls,2843,6577,43.2,2335,5118,45.6,508,1459,34.8,1486,1908,937,3620,1860,1223,7680,2014,True,Knocked Out
Golden State Warriors,3410,7137,47.8,2527,4920,51.4,883,2217,39.800000000000004,1313,1709,853,3667,2248,1185,9016,2015,True,Champion
Los Angeles Clippers,3228,6830,47.3,2401,4628,51.9,827,2202,37.6,1468,2067,784,3495,2031,1012,8751,2015,True,Knocked Out
Dallas Mavericks,3255,7036,46.300000000000004,2523,4954,50.9,732,2082,35.199999999999996,1386,1843,858,3466,1846,1062,8628,2015,True,Knocked Out
Toronto Raptors,3108,6829,45.5,2382,4769,49.9,726,2060,35.199999999999996,1585,2014,881,3407,1701,1057,8527,2015,True,Knocked Out
Oklahoma City Thunder,3184,7119,44.7,2552,5255,48.6,632,1864,33.900000000000006,1524,2020,1052,3896,1681,1205,8524,2015,False,Never Qualified
Houston Rockets,3032,6832,44.4,2099,4152,50.6,933,2680,34.8,1525,2133,958,3582,1820,1366,8522,2015,True,Knocked Out
San Antonio Spurs,3208,6854,46.800000000000004,2531,5007,50.5,677,1847,36.7,1368,1754,806,3578,2000,1146,8461,2015,True,Knocked Out
Cleveland Cavaliers,3089,6739,45.800000000000004,2263,4486,50.4,826,2253,36.7,1453,1934,911,3523,1814,1171,8457,2015,True,Runner-Up
Portland Trail Blazers,3175,7049,45.0,2368,4818,49.1,807,2231,36.199999999999996,1272,1589,879,3760,1799,1117,8429,2015,True,Knocked Out
Atlanta Hawks,3121,6699,46.6,2303,4547,50.6,818,2152,38.0,1349,1735,715,3326,2111,1167,8409,2015,True,Knocked Out
Phoenix Suns,3178,7038,45.2,2480,4990,49.7,698,2048,34.1,1343,1767,896,3539,1659,1238,8397,2015,False,Never Qualified
Denver Nuggets,3099,7158,43.3,2439,5126,47.599999999999994,660,2032,32.5,1462,1991,1012,3665,1788,1166,8320,2015,False,Never Qualified
Boston Celtics,3193,7211,44.3,2533,5190,48.8,660,2021,32.7,1266,1678,910,3595,2009,1133,8312,2015,True,Knocked Out
Sacramento Kings,3010,6617,45.5,2549,5267,48.4,461,1350,34.1,1829,2400,895,3623,1667,1333,8310,2015,False,Never Qualified
Chicago Bulls,3001,6797,44.2,2356,4972,47.4,645,1825,35.3,1618,2067,959,3751,1781,1145,8265,2015,True,Knocked Out
New Orleans Pelicans,3108,6795,45.7,2522,5212,48.4,586,1583,37.0,1345,1790,942,3563,1806,1087,8147,2015,True,Knocked Out
Washington Wizards,3139,6790,46.2,2642,5409,48.8,497,1381,36.0,1305,1758,862,3663,1969,1233,8080,2015,True,Knocked Out
Detroit Pistons,3041,7038,43.2,2338,4995,46.800000000000004,703,2043,34.4,1292,1838,1051,3681,1771,1099,8077,2015,False,Never Qualified
Los Angeles Lakers,3054,7020,43.5,2522,5474,46.1,532,1546,34.4,1433,1935,952,3599,1715,1086,8073,2015,False,Never Qualified
Memphis Grizzlies,3097,6763,45.800000000000004,2674,5517,48.5,423,1246,33.900000000000006,1445,1869,856,3490,1777,1094,8062,2015,True,Knocked Out
Brooklyn Nets,3069,6804,45.1,2528,5171,48.9,541,1633,33.1,1359,1817,846,3473,1716,1133,8038,2015,True,Knocked Out
Milwaukee Bucks,3083,6722,45.9,2538,5222,48.6,545,1500,36.3,1312,1734,876,3450,1932,1373,8023,2015,True,Knocked Out
Minnesota Timberwolves,2986,6820,43.8,2580,5597,46.1,406,1223,33.2,1638,2110,949,3355,1771,1231,8016,2015,False,Never Qualified
Indiana Pacers,2998,6824,43.9,2386,5084,46.9,612,1740,35.199999999999996,1373,1817,856,3678,1757,1147,7981,2015,False,Never Qualified
Orlando Magic,3076,6792,45.300000000000004,2522,5194,48.6,554,1598,34.699999999999996,1141,1565,822,3429,1692,1221,7847,2015,False,Never Qualified
Utah Jazz,2900,6492,44.7,2290,4711,48.6,610,1781,34.300000000000004,1391,1929,988,3605,1632,1256,7801,2015,False,Never Qualified
Miami Heat,2885,6330,45.6,2329,4671,49.9,556,1659,33.5,1438,1940,747,3208,1626,1214,7764,2015,False,Never Qualified
Charlotte Hornets,2913,6932,42.0,2415,5366,45.0,498,1566,31.8,1397,1867,820,3613,1654,976,7721,2015,False,Never Qualified
Philadelphia 76ers,2765,6777,40.8,2073,4617,44.9,692,2160,32.0,1320,1953,978,3514,1683,1453,7542,2015,False,Never Qualified
New York Knicks,2882,6726,42.8,2322,5112,45.4,560,1614,34.699999999999996,1211,1575,867,3310,1746,1206,7535,2015,False,Never Qualified
Golden State Warriors,3489,7159,48.699999999999996,2412,4567,52.800000000000004,1077,2592,41.6,1366,1790,816,3788,2373,1245,9421,2016,True,Runner-Up
Oklahoma City Thunder,3372,7082,47.599999999999994,2694,5137,52.400000000000006,678,1945,34.9,1616,2067,1071,3987,1883,1305,9038,2016,True,Knocked Out
Sacramento Kings,3283,7083,46.400000000000006,2623,5244,50.0,660,1839,35.9,1514,2089,868,3628,2009,1326,8740,2016,False,Never Qualified
Houston Rockets,3094,6847,45.2,2216,4314,51.4,878,2533,34.699999999999996,1671,2407,930,3531,1821,1307,8737,2016,True,Knocked Out
Boston Celtics,3216,7318,43.9,2499,5176,48.3,717,2142,33.5,1520,1929,950,3683,1981,1127,8669,2016,True,Knocked Out
Portland Trail Blazers,3167,7040,45.0,2303,4704,49.0,864,2336,37.0,1424,1889,948,3730,1748,1200,8622,2016,True,Knocked Out
Los Angeles Clippers,3141,6759,46.5,2344,4569,51.300000000000004,797,2190,36.4,1490,2152,721,3448,1873,1063,8569,2016,True,Knocked Out
Cleveland Cavaliers,3171,6888,46.0,2291,4460,51.4,880,2428,36.199999999999996,1333,1783,873,3650,1861,1114,8555,2016,True,Champion
Washington Wizards,3238,7033,46.0,2529,5050,50.1,709,1983,35.8,1349,1849,743,3431,2005,1186,8534,2016,False,Never Qualified
San Antonio Spurs,3289,6797,48.4,2719,5279,51.5,570,1518,37.5,1342,1672,770,3601,2010,1071,8490,2016,True,Knocked Out
Charlotte Hornets,3036,6922,43.9,2163,4512,47.9,873,2410,36.199999999999996,1534,1941,734,3603,1778,1030,8479,2016,True,Knocked Out
Atlanta Hawks,3168,6923,45.800000000000004,2353,4597,51.2,815,2326,35.0,1282,1638,679,3451,2100,1226,8433,2016,True,Knocked Out
New Orleans Pelicans,3153,7040,44.800000000000004,2451,5089,48.199999999999996,702,1951,36.0,1415,1823,782,3494,1818,1102,8423,2016,False,Never Qualified
Toronto Raptors,3006,6669,45.1,2298,4754,48.3,708,1915,37.0,1702,2190,836,3560,1536,1073,8422,2016,True,Knocked Out
Minnesota Timberwolves,3095,6668,46.400000000000006,2640,5321,49.6,455,1347,33.800000000000004,1753,2213,821,3408,1916,1231,8398,2016,False,Never Qualified
Dallas Mavericks,3064,6900,44.4,2258,4558,49.5,806,2342,34.4,1454,1831,751,3532,1813,1047,8388,2016,True,Knocked Out
Indiana Pacers,3142,6985,45.0,2479,5096,48.6,663,1889,35.099999999999994,1430,1872,847,3626,1741,1219,8377,2016,True,Knocked Out
Orlando Magic,3242,7120,45.5,2606,5302,49.2,636,1818,35.0,1249,1649,843,3552,1933,1155,8369,2016,False,Never Qualified
Detroit Pistons,3111,7087,43.9,2371,4939,48.0,740,2148,34.5,1399,2095,1021,3798,1594,1110,8361,2016,True,Knocked Out
Denver Nuggets,3093,7003,44.2,2437,5060,48.199999999999996,656,1943,33.800000000000004,1513,1974,941,3659,1858,1202,8355,2016,False,Never Qualified
Chicago Bulls,3165,7170,44.1,2514,5417,46.400000000000006,651,1753,37.1,1354,1720,907,3796,1870,1141,8335,2016,False,Never Qualified
Phoenix Suns,3051,7018,43.5,2313,4900,47.199999999999996,738,2118,34.8,1431,1905,943,3676,1701,1410,8271,2016,False,Never Qualified
Miami Heat,3150,6697,47.0,2652,5217,50.8,498,1480,33.6,1406,1889,807,3618,1709,1155,8204,2016,True,Knocked Out
Memphis Grizzlies,3019,6859,44.0,2515,5338,47.099999999999994,504,1521,33.1,1584,2024,916,3413,1697,1090,8126,2016,True,Knocked Out
Milwaukee Bucks,3145,6740,46.7,2705,5463,49.5,440,1277,34.5,1392,1863,858,3417,1895,1247,8122,2016,False,Never Qualified
Brooklyn Nets,3136,6920,45.300000000000004,2605,5412,48.1,531,1508,35.199999999999996,1286,1699,863,3477,1829,1212,8089,2016,False,Never Qualified
New York Knicks,3022,6886,43.9,2412,5124,47.099999999999994,610,1762,34.599999999999994,1411,1753,850,3638,1682,1099,8065,2016,False,Never Qualified
Utah Jazz,2957,6593,44.9,2263,4637,48.8,694,1956,35.5,1402,1885,880,3545,1555,1224,8010,2016,False,Never Qualified
Philadelphia 76ers,2970,6887,43.1,2206,4632,47.599999999999994,764,2255,33.900000000000006,1284,1850,777,3382,1765,1343,7988,2016,False,Never Qualified
Los Angeles Lakers,2880,6956,41.4,2241,4940,45.4,639,2016,31.7,1583,2028,878,3523,1478,1124,7982,2016,False,Never Qualified
Golden State Warriors,3532,7140,49.5,2550,4578,55.7,982,2562,38.3,1457,1850,770,3643,2491,1211,9503,2017,True,Champion
Houston Rockets,3305,7152,46.2,2124,3846,55.2,1181,3306,35.699999999999996,1667,2177,892,3638,2070,1240,9458,2017,True,Knocked Out
Denver Nuggets,3377,7194,46.9,2507,4829,51.9,870,2365,36.8,1537,1986,966,3803,2077,1226,9161,2017,False,Never Qualified
Cleveland Cavaliers,3275,6963,47.0,2208,4184,52.800000000000004,1067,2779,38.4,1431,1913,766,3587,1858,1121,9048,2017,True,Runner-Up
Washington Wizards,3388,7137,47.5,2632,5107,51.5,756,2030,37.2,1421,1812,843,3514,1956,1162,8953,2017,True,Knocked Out
Los Angeles Clippers,3242,6820,47.5,2401,4575,52.5,841,2245,37.5,1586,2128,738,3528,1848,1062,8911,2017,True,Knocked Out
Boston Celtics,3168,6978,45.4,2183,4236,51.5,985,2742,35.9,1536,1903,744,3442,2069,1088,8857,2017,True,Knocked Out
Portland Trail Blazers,3243,7059,45.9,2391,4787,49.9,852,2272,37.5,1513,1940,830,3580,1733,1126,8851,2017,True,Knocked Out
Phoenix Suns,3270,7260,45.0,2655,5406,49.1,615,1854,33.2,1676,2159,976,3688,1604,1265,8831,2017,False,Never Qualified
Toronto Raptors,3211,6918,46.400000000000006,2486,4922,50.5,725,1996,36.3,1615,2028,871,3547,1517,1041,8762,2017,True,Knocked Out
Oklahoma City Thunder,3237,7169,45.2,2545,5053,50.4,692,2116,32.7,1575,2113,1002,3823,1721,1230,8741,2017,True,Knocked Out
Brooklyn Nets,3102,6987,44.4,2225,4396,50.6,877,2591,33.800000000000004,1592,2020,721,3600,1756,1356,8673,2017,False,Never Qualified
Minnesota Timberwolves,3235,6922,46.7,2634,5199,50.7,601,1723,34.9,1586,1986,938,3478,1940,1150,8657,2017,False,Never Qualified
San Antonio Spurs,3222,6864,46.9,2469,4937,50.0,753,1927,39.1,1440,1806,821,3598,1954,1101,8637,2017,True,Knocked Out
Indiana Pacers,3221,6931,46.5,2512,5046,49.8,709,1885,37.6,1467,1811,742,3444,1844,1130,8618,2017,True,Knocked Out
Charlotte Hornets,3093,7000,44.2,2269,4653,48.8,824,2347,35.099999999999994,1591,1953,721,3574,1891,942,8601,2017,False,Never Qualified
Los Angeles Lakers,3224,7164,45.0,2494,5054,49.3,730,2110,34.599999999999994,1397,1853,933,3569,1716,1243,8575,2017,False,Never Qualified
New Orleans Pelicans,3210,7130,45.0,2442,4934,49.5,768,2196,35.0,1368,1825,703,3582,1869,1054,8556,2017,False,Never Qualified
New York Knicks,3244,7256,44.7,2540,5234,48.5,704,2022,34.8,1364,1731,983,3706,1786,1139,8556,2017,False,Never Qualified
Milwaukee Bucks,3182,6715,47.4,2462,4769,51.6,720,1946,37.0,1413,1839,723,3312,1984,1145,8497,2017,True,Knocked Out
Miami Heat,3202,7037,45.5,2394,4824,49.6,808,2213,36.5,1248,1768,872,3577,1742,1102,8460,2017,False,Never Qualified
Atlanta Hawks,3123,6918,45.1,2394,4781,50.1,729,2137,34.1,1484,2039,842,3635,1938,1294,8459,2017,True,Knocked Out
Chicago Bulls,3169,7141,44.4,2546,5310,47.9,623,1831,34.0,1474,1848,999,3796,1851,1112,8435,2017,True,Knocked Out
Sacramento Kings,3105,6734,46.1,2368,4774,49.6,737,1960,37.6,1483,1913,715,3367,1844,1201,8430,2017,False,Never Qualified
Philadelphia 76ers,3088,6992,44.2,2257,4549,49.6,831,2443,34.0,1393,1806,807,3513,1949,1366,8400,2017,False,Never Qualified
Detroit Pistons,3269,7282,44.9,2638,5367,49.2,631,1915,33.0,1140,1586,908,3746,1732,973,8309,2017,False,Never Qualified
Orlando Magic,3139,7133,44.0,2438,4994,48.8,701,2139,32.800000000000004,1309,1753,807,3541,1820,1091,8288,2017,False,Never Qualified
Utah Jazz,3033,6515,46.6,2242,4387,51.1,791,2128,37.2,1401,1875,771,3545,1651,1118,8258,2017,True,Knocked Out
Memphis Grizzlies,2984,6854,43.5,2217,4685,47.3,767,2169,35.4,1504,1918,886,3507,1744,1059,8239,2017,True,Knocked Out
Dallas Mavericks,2968,6750,44.0,2090,4277,48.9,878,2473,35.5,1215,1516,647,3163,1705,972,8029,2017,False,Never Qualified
Golden State Warriors,3509,6981,50.3,2583,4611,56.00000000000001,926,2370,39.1,1360,1668,691,3568,2402,1267,9304,2018,True,Champion
Houston Rockets,3174,6906,46.0,1918,3436,55.800000000000004,1256,3470,36.199999999999996,1609,2061,739,3564,1767,1135,9213,2018,True,Knocked Out
New Orleans Pelicans,3500,7241,48.3,2663,4929,54.0,837,2312,36.199999999999996,1324,1716,712,3636,2195,1223,9161,2018,True,Knocked Out
Toronto Raptors,3383,7169,47.199999999999996,2415,4464,54.1,968,2705,35.8,1422,1790,800,3607,1995,1095,9156,2018,True,Knocked Out
Cleveland Cavaliers,3311,6950,47.599999999999994,2330,4314,54.0,981,2636,37.2,1488,1909,694,3455,1916,1126,9091,2018,True,Runner-Up
Denver Nuggets,3338,7102,47.0,2398,4566,52.5,940,2536,37.1,1404,1830,902,3650,2059,1227,9020,2018,False,Never Qualified
Philadelphia 76ers,3349,7098,47.199999999999996,2448,4653,52.6,901,2445,36.9,1405,1868,893,3889,2221,1353,9004,2018,True,Knocked Out
Minnesota Timberwolves,3365,7063,47.599999999999994,2707,5218,51.9,658,1845,35.699999999999996,1592,1980,848,3441,1861,1021,8980,2018,True,Knocked Out
Los Angeles Clippers,3302,7004,47.099999999999994,2525,4808,52.5,777,2196,35.4,1556,2095,832,3598,1832,1204,8937,2018,False,Never Qualified
Charlotte Hornets,3197,7106,45.0,2373,4873,48.699999999999996,824,2233,36.9,1656,2216,827,3728,1770,1041,8874,2018,False,Never Qualified
Los Angeles Lakers,3338,7248,46.1,2516,4864,51.7,822,2384,34.5,1364,1910,876,3803,1949,1295,8862,2018,False,Never Qualified
Oklahoma City Thunder,3271,7221,45.300000000000004,2390,4730,50.5,881,2491,35.4,1421,1985,1024,3695,1750,1147,8844,2018,True,Knocked Out
Washington Wizards,3275,7018,46.7,2461,4845,50.8,814,2173,37.5,1378,1786,823,3536,2065,1196,8742,2018,True,Knocked Out
Brooklyn Nets,3136,7114,44.1,2095,4190,50.0,1041,2924,35.6,1428,1850,792,3644,1941,1245,8741,2018,False,Never Qualified
Milwaukee Bucks,3257,6807,47.8,2539,4783,53.1,718,2024,35.5,1499,1915,688,3267,1905,1134,8731,2018,True,Knocked Out
Portland Trail Blazers,3222,7132,45.2,2377,4824,49.3,845,2308,36.6,1372,1715,835,3728,1599,1109,8661,2018,True,Knocked Out
Indiana Pacers,3345,7083,47.199999999999996,2604,5073,51.300000000000004,741,2010,36.9,1225,1573,788,3472,1819,1089,8656,2018,True,Knocked Out
New York Knicks,3334,7193,46.400000000000006,2661,5279,50.4,673,1914,35.199999999999996,1225,1557,859,3611,1912,1207,8566,2018,False,Never Qualified
Utah Jazz,3139,6797,46.2,2252,4372,51.5,887,2425,36.6,1375,1766,740,3547,1839,1205,8540,2018,True,Knocked Out
Boston Celtics,3141,6975,45.0,2202,4483,49.1,939,2492,37.7,1308,1697,767,3645,1842,1149,8529,2018,True,Knocked Out
Phoenix Suns,3153,7141,44.2,2390,4855,49.2,763,2286,33.4,1453,1962,842,3618,1743,1289,8522,2018,False,Never Qualified
Detroit Pistons,3208,7129,45.0,2322,4756,48.8,886,2373,37.3,1207,1621,830,3586,1868,1103,8509,2018,False,Never Qualified
Miami Heat,3184,6997,45.5,2281,4491,50.8,903,2506,36.0,1209,1601,763,3564,1862,1179,8480,2018,True,Knocked Out
Orlando Magic,3182,7042,45.2,2338,4637,50.4,844,2405,35.099999999999994,1271,1678,722,3414,1921,1192,8479,2018,False,Never Qualified
Atlanta Hawks,3130,7015,44.6,2213,4471,49.5,917,2544,36.0,1298,1654,743,3436,1946,1276,8475,2018,False,Never Qualified
Chicago Bulls,3170,7285,43.5,2264,4736,47.8,906,2549,35.5,1194,1574,790,3663,1923,1147,8440,2018,False,Never Qualified
San Antonio Spurs,3202,6999,45.7,2506,5022,49.9,696,1977,35.199999999999996,1324,1715,849,3626,1868,1078,8424,2018,True,Knocked Out
Dallas Mavericks,3128,7042,44.4,2161,4354,49.6,967,2688,36.0,1167,1530,666,3383,1858,1008,8390,2018,False,Never Qualified
Memphis Grizzlies,3013,6788,44.4,2255,4636,48.6,758,2152,35.199999999999996,1361,1732,779,3323,1767,1227,8145,2018,False,Never Qualified
Sacramento Kings,3179,7063,45.0,2441,5096,47.9,738,1967,37.5,1008,1371,777,3355,1768,1125,8104,2018,False,Never Qualified
Milwaukee Bucks,3555,7471,47.599999999999994,2450,4337,56.49999999999999,1105,3134,35.3,1471,1904,762,4078,2136,1137,9686,2019,True,Knocked Out
Golden State Warriors,3612,7361,49.1,2525,4537,55.7,1087,2824,38.5,1339,1672,797,3787,2413,1169,9650,2019,True,Runner-Up
New Orleans Pelicans,3581,7563,47.3,2739,5114,53.6,842,2449,34.4,1462,1921,909,3878,2216,1215,9466,2019,False,Never Qualified
Philadelphia 76ers,3407,7233,47.099999999999994,2518,4759,52.900000000000006,889,2474,35.9,1742,2258,892,3917,2207,1223,9445,2019,True,Knocked Out
Los Angeles Clippers,3384,7178,47.099999999999994,2563,5060,50.7,821,2118,38.800000000000004,1853,2340,796,3732,1970,1193,9442,2019,True,Knocked Out
Portland Trail Blazers,3470,7427,46.7,2566,4907,52.300000000000004,904,2520,35.9,1558,1914,967,3935,1887,1135,9402,2019,True,Knocked Out
Oklahoma City Thunder,3497,7706,45.4,2565,5029,51.0,932,2677,34.8,1461,2049,1031,3942,1917,1145,9387,2019,True,Knocked Out
Toronto Raptors,3460,7305,47.4,2445,4534,53.900000000000006,1015,2771,36.6,1449,1803,786,3706,2085,1150,9384,2019,True,Champion
Sacramento Kings,3541,7637,46.400000000000006,2614,5182,50.4,927,2455,37.8,1354,1865,906,3725,2083,1095,9363,2019,False,Never Qualified
Washington Wizards,3456,7387,46.800000000000004,2526,4656,54.300000000000004,930,2731,34.1,1508,1963,794,3473,2154,1154,9350,2019,False,Never Qualified
Houston Rockets,3218,7163,44.9,1895,3442,55.1,1323,3721,35.6,1582,2001,836,3449,1741,1094,9341,2019,True,Knocked Out
Atlanta Hawks,3392,7524,45.1,2325,4490,51.800000000000004,1067,3034,35.199999999999996,1443,1918,955,3780,2118,1397,9294,2019,False,Never Qualified
Minnesota Timberwolves,3413,7483,45.6,2586,5126,50.4,827,2357,35.099999999999994,1570,1995,923,3673,2018,1074,9223,2019,False,Never Qualified
Boston Celtics,3451,7423,46.5,2419,4594,52.7,1032,2829,36.5,1282,1598,804,3653,2155,1052,9216,2019,True,Knocked Out
Brooklyn Nets,3301,7358,44.9,2254,4393,51.300000000000004,1047,2965,35.3,1555,2088,900,3819,1954,1236,9204,2019,True,Knocked Out
Los Angeles Lakers,3491,7425,47.0,2644,4884,54.1,847,2541,33.300000000000004,1336,1910,835,3820,2096,1284,9165,2019,False,Never Qualified
Utah Jazz,3314,7082,46.800000000000004,2321,4293,54.1,993,2789,35.6,1540,2092,820,3801,2133,1240,9161,2019,True,Knocked Out
San Antonio Spurs,3468,7248,47.8,2656,5177,51.300000000000004,812,2071,39.2,1408,1720,757,3667,2013,992,9156,2019,True,Knocked Out
Charlotte Hornets,3297,7362,44.800000000000004,2320,4579,50.7,977,2783,35.099999999999994,1510,1895,814,3592,1905,1001,9081,2019,False,Never Qualified
Denver Nuggets,3439,7384,46.6,2536,4813,52.7,903,2571,35.099999999999994,1294,1714,972,3804,2245,1102,9075,2019,True,Knocked Out
Dallas Mavericks,3182,7122,44.7,2160,4120,52.400000000000006,1022,3002,34.0,1541,2076,832,3716,1918,1167,8927,2019,False,Never Qualified
Indiana Pacers,3390,7135,47.5,2611,5054,51.7,779,2081,37.4,1298,1727,762,3528,2128,1122,8857,2019,True,Knocked Out
Phoenix Suns,3289,7164,45.9,2499,4764,52.5,790,2400,32.9,1447,1858,748,3311,1957,1279,8815,2019,False,Never Qualified
Orlando Magic,3316,7307,45.4,2379,4674,50.9,937,2633,35.6,1231,1575,822,3724,2095,1082,8800,2019,True,Knocked Out
Detroit Pistons,3185,7238,44.0,2192,4384,50.0,993,2854,34.8,1415,1893,936,3688,1845,1135,8778,2019,True,Knocked Out
Miami Heat,3251,7218,45.0,2323,4560,50.9,928,2658,34.9,1238,1782,921,3800,1991,1208,8668,2019,False,Never Qualified
Chicago Bulls,3266,7205,45.300000000000004,2521,5082,49.6,745,2123,35.099999999999994,1328,1695,718,3517,1796,1159,8605,2019,False,Never Qualified
New York Knicks,3134,7241,43.3,2311,4820,47.9,823,2421,34.0,1484,1956,857,3668,1646,1151,8575,2019,False,Never Qualified
Cleveland Cavaliers,3189,7184,44.4,2342,4796,48.8,847,2388,35.5,1342,1694,879,3498,1698,1106,8567,2019,False,Never Qualified
Memphis Grizzlies,3113,6924,45.0,2302,4556,50.5,811,2368,34.2,1453,1882,723,3426,1963,1147,8490,2019,False,Never Qualified
Dallas Mavericks,3124,6772,46.1,1988,3677,54.1,1136,3095,36.7,1392,1787,791,3520,1849,953,8776,2020,True,Knocked Out
Milwaukee Bucks,3160,6638,47.599999999999994,2153,3798,56.699999999999996,1007,2840,35.5,1336,1800,691,3774,1889,1102,8663,2020,True,Knocked Out
Portland Trail Blazers,3122,6749,46.300000000000004,2170,4224,51.4,952,2525,37.7,1312,1632,754,3353,1525,946,8508,2020,True,Knocked Out
Houston Rockets,2936,6512,45.1,1810,3251,55.7,1126,3261,34.5,1484,1876,704,3188,1557,1057,8482,2020,True,Knocked Out
Los Angeles Clippers,2992,6425,46.6,2097,4015,52.2,895,2410,37.1,1498,1894,767,3431,1708,1051,8377,2020,True,Knocked Out
New Orleans Pelicans,3065,6598,46.5,2083,3942,52.800000000000004,982,2656,37.0,1229,1687,797,3348,1932,1181,8341,2020,False,Never Qualified
Phoenix Suns,3006,6429,46.800000000000004,2175,4109,52.900000000000006,831,2320,35.8,1451,1740,712,3177,1987,1077,8294,2020,False,Never Qualified
Washington Wizards,2990,6544,45.7,2126,4199,50.6,864,2345,36.8,1394,1770,732,3027,1801,1020,8238,2020,False,Never Qualified
Memphis Grizzlies,3106,6634,46.800000000000004,2308,4337,53.2,798,2297,34.699999999999996,1212,1589,754,3397,1965,1113,8222,2020,False,Never Qualified
Boston Celtics,2971,6448,46.1,2066,3961,52.2,905,2487,36.4,1336,1668,768,3317,1655,995,8183,2020,True,Knocked Out
Miami Heat,2880,6160,46.800000000000004,1901,3576,53.2,979,2584,37.9,1440,1840,620,3239,1892,1088,8179,2020,True,Runner-Up
Denver Nuggets,3069,6488,47.3,2268,4254,53.300000000000004,801,2234,35.9,1185,1526,786,3222,1952,1005,8124,2020,True,Knocked Out
Toronto Raptors,2897,6331,45.800000000000004,1902,3668,51.9,995,2663,37.4,1329,1670,685,3268,1816,1067,8118,2020,True,Knocked Out
San Antonio Spurs,2995,6350,47.199999999999996,2235,4329,51.6,760,2021,37.6,1348,1664,640,3170,1751,895,8098,2020,False,Never Qualified
Philadelphia 76ers,3000,6417,46.800000000000004,2152,4110,52.400000000000006,848,2307,36.8,1236,1638,764,3317,1884,1037,8084,2020,True,Knocked Out
Los Angeles Lakers,3006,6269,48.0,2224,4027,55.2,782,2242,34.9,1260,1728,757,3247,1803,1077,8054,2020,True,Champion
Brooklyn Nets,2908,6498,44.800000000000004,1967,3752,52.400000000000006,941,2746,34.300000000000004,1291,1732,766,3449,1761,1099,8048,2020,True,Knocked Out
Utah Jazz,2886,6130,47.099999999999994,1923,3593,53.5,963,2537,38.0,1278,1641,656,3233,1615,1089,8013,2020,True,Knocked Out
Indiana Pacers,3075,6457,47.599999999999994,2332,4411,52.900000000000006,743,2046,36.3,1096,1393,636,3125,1888,967,7989,2020,True,Knocked Out
Oklahoma City Thunder,2879,6156,46.800000000000004,2109,3985,52.900000000000006,770,2171,35.5,1422,1787,593,3088,1562,986,7950,2020,True,Knocked Out
Sacramento Kings,2943,6364,46.2,2029,3853,52.7,914,2511,36.4,1127,1464,695,3067,1713,1043,7927,2020,False,Never Qualified
Orlando Magic,2871,6468,44.4,2064,4114,50.2,807,2354,34.300000000000004,1282,1656,751,3249,1747,937,7831,2020,True,Knocked Out
Atlanta Hawks,2723,6067,44.9,1918,3651,52.5,805,2416,33.300000000000004,1237,1566,661,2898,1605,1086,7488,2020,False,Never Qualified
Minnesota Timberwolves,2586,5865,44.1,1733,3325,52.1,853,2540,33.6,1223,1624,675,2868,1525,981,7248,2020,False,Never Qualified
Detroit Pistons,2595,5658,45.9,1804,3501,51.5,791,2157,36.7,1097,1476,644,2753,1589,1008,7078,2020,False,Never Qualified
New York Knicks,2638,5896,44.7,2007,4024,49.9,631,1872,33.7,1076,1550,795,3069,1456,946,6983,2020,False,Never Qualified
Cleveland Cavaliers,2619,5715,45.800000000000004,1892,3645,51.9,727,2070,35.099999999999994,983,1296,704,2876,1500,1073,6948,2020,False,Never Qualified
Chicago Bulls,2573,5762,44.7,1780,3480,51.1,793,2282,34.8,1006,1332,680,2721,1510,1005,6945,2020,False,Never Qualified
Golden State Warriors,2510,5730,43.8,1832,3698,49.5,678,2032,33.4,1214,1511,647,2785,1663,969,6912,2020,False,Never Qualified
Charlotte Hornets,2425,5586,43.4,1640,3355,48.9,785,2231,35.199999999999996,1052,1406,715,2781,1549,949,6687,2020,False,Never Qualified
Milwaukee Bucks,3221,6610,48.699999999999996,2183,3941,55.400000000000006,1038,2669,38.9,1169,1539,741,3465,1834,995,8649,2021,True,Champion
Brooklyn Nets,3106,6289,49.4,2086,3689,56.49999999999999,1020,2600,39.2,1305,1623,640,3199,1929,975,8537,2021,True,Knocked Out
Washington Wizards,3108,6547,47.5,2375,4459,53.300000000000004,733,2088,35.099999999999994,1449,1884,697,3254,1835,1037,8398,2021,True,Knocked Out
Utah Jazz,2971,6344,46.800000000000004,1766,3246,54.400000000000006,1205,3098,38.9,1235,1546,765,3474,1703,1023,8382,2021,True,Knocked Out
Portland Trail Blazers,2973,6558,45.300000000000004,1841,3619,50.9,1132,2939,38.5,1282,1558,766,3207,1531,799,8360,2021,True,Knocked Out
Indiana Pacers,3115,6567,47.4,2226,4122,54.0,889,2445,36.4,1183,1493,648,3072,1973,975,8302,2021,False,Never Qualified
Phoenix Suns,3118,6357,49.0,2178,3867,56.3,940,2490,37.8,1124,1347,630,3092,1939,902,8300,2021,True,Runner-Up
Denver Nuggets,3114,6422,48.5,2187,3960,55.2,927,2462,37.7,1129,1406,758,3200,1933,972,8284,2021,True,Knocked Out
New Orleans Pelicans,3060,6412,47.699999999999996,2298,4222,54.400000000000006,762,2190,34.8,1369,1878,845,3413,1872,1052,8251,2021,False,Never Qualified
Los Angeles Clippers,3009,6242,48.199999999999996,1982,3744,52.900000000000006,1027,2498,41.099999999999994,1164,1387,678,3179,1756,950,8209,2021,True,Knocked Out
Sacramento Kings,3067,6382,48.1,2193,3982,55.1,874,2400,36.4,1181,1585,674,2981,1836,963,8189,2021,False,Never Qualified
Golden State Warriors,2973,6347,46.800000000000004,1925,3558,54.1,1048,2789,37.6,1193,1520,574,3098,1991,1080,8187,2021,False,Never Qualified
Atlanta Hawks,2937,6281,46.800000000000004,2042,3879,52.6,895,2402,37.3,1417,1745,760,3285,1737,953,8186,2021,True,Knocked Out
Philadelphia 76ers,2981,6257,47.599999999999994,2170,4088,53.1,811,2169,37.4,1409,1836,722,3244,1706,1040,8182,2021,True,Knocked Out
Memphis Grizzlies,3085,6608,46.7,2282,4350,52.5,803,2258,35.6,1184,1536,803,3346,1938,957,8157,2021,True,Knocked Out
Boston Celtics,2985,6401,46.6,2006,3783,53.0,979,2618,37.4,1160,1496,765,3186,1689,1012,8109,2021,True,Knocked Out
Dallas Mavericks,2958,6287,47.0,1964,3543,55.400000000000006,994,2744,36.199999999999996,1186,1524,657,3120,1647,869,8096,2021,True,Knocked Out
Minnesota Timberwolves,2932,6546,44.800000000000004,1988,3840,51.800000000000004,944,2706,34.9,1265,1662,757,3133,1846,1027,8073,2021,False,Never Qualified
Toronto Raptors,2859,6383,44.800000000000004,1818,3552,51.2,1041,2831,36.8,1252,1536,680,2994,1735,952,8011,2021,False,Never Qualified
San Antonio Spurs,3014,6518,46.2,2298,4472,51.4,716,2046,35.0,1254,1584,669,3158,1759,821,7998,2021,False,Never Qualified
Chicago Bulls,3035,6380,47.599999999999994,2131,3934,54.2,904,2446,37.0,995,1258,693,3237,1927,1089,7969,2021,False,Never Qualified
Los Angeles Lakers,2925,6197,47.199999999999996,2129,3949,53.900000000000006,796,2248,35.4,1241,1679,695,3185,1775,1095,7887,2021,True,Knocked Out
Charlotte Hornets,2875,6324,45.5,1890,3658,51.7,985,2666,36.9,1146,1505,762,3151,1933,1069,7881,2021,False,Never Qualified
Houston Rockets,2826,6372,44.4,1834,3449,53.2,992,2923,33.900000000000006,1189,1606,671,3067,1699,1060,7833,2021,False,Never Qualified
Miami Heat,2824,6029,46.800000000000004,1892,3423,55.300000000000004,932,2606,35.8,1201,1520,579,2988,1895,1013,7781,2021,True,Knocked Out
New York Knicks,2839,6225,45.6,1992,4062,49.0,847,2163,39.2,1181,1506,696,3250,1541,932,7706,2021,True,Knocked Out
Detroit Pistons,2783,6162,45.2,1951,3792,51.5,832,2370,35.099999999999994,1278,1683,694,3075,1743,1075,7676,2021,False,Never Qualified
Oklahoma City Thunder,2795,6338,44.1,1938,3809,50.9,857,2529,33.900000000000006,1113,1536,715,3283,1588,1162,7560,2021,False,Never Qualified
Orlando Magic,2754,6423,42.9,1970,4135,47.599999999999994,784,2288,34.300000000000004,1196,1543,747,3272,1571,924,7488,2021,False,Never Qualified
Cleveland Cavaliers,2778,6175,45.0,2058,4034,51.0,720,2141,33.6,1200,1614,751,3078,1716,1114,7476,2021,False,Never Qualified
